Xu, Xu, Xu, Xu, Xu, Xu, Xu, Xu, Xu, Xu, Xu, Xu, Xu, Xu, Xu, Xu, Xu, Xu, Xu, Xu, Xu, Xu
Uh, Uh, Xu, Xu, Xu, Xu, Xu, Xu, Xu, Xu, Xu, Xu, Xu, Xu, Xu, Xu, Xu, Xu, Xu, Xu, Xu, Xu
Uh, Uh, Uh, Xu, Xu, Xu, Xu, Xu, Xu, Xu, Xu, Xu, Xu, Xu, Xu, Xu, Xu, Xu, Xu, Xu, Xu, Xu
Uu, 1 Uh, Uh, Xu, Xu, Xu, Cte, Xu, Cte, Cte, Cte, Cte, Cte, Cte, Cte, Xu, Cte, Xu, Xu, Xu, Xu, Xu
Ur, 2 Ur, Ur, Ur, Ur, Uu, Ur, Cte, Ur, Cte, Cte, Cte^Es, Cte, 3 Kte, Cte^Es, Cte, Cte, Xu, Xu, Xu, Xu, Xu
Xu, Xu, Xu, Uu, Uu, Ur, Uu, Ur, Ur, Cte, Cte, Cte, Cte, Cte, Cte^Es, Cte^Es, Cte, Cte, Cte, Xu, Xu, Xu
Xu, Xu, Xu, Xu, Xu, Uu^Vu, Xu, Uu, Cte, Ur, Cte, Cte, Cte, Cte, Cte, Cte, Cte, Cte, Cte, Xu, Xu, Xu
Xu, Xu, Xu, Xu, Xu, Xu, Xu, Cte, Cte, Ur, Ur, Cte, Ur, Cte, Ur, Cte, Cte, Cte, Xu, Xu, Xu, Xu
Xu, Xu, Xu, Xu, Xu, Uh, Cte, Kte, Cte, Cte, Ur, Ur, Cte, Ur, Uu, Xu, Xu, Cte, Xu, Xu, Xu, Xu
Xu, Xu, Xu, Xu, Uh, Uh, Cte, Cte, Cte, Cte, Ur, Cte, Cte, Ur, Uu^Vu, Xu, Xu, Xu, Xu, Xu, Xu, Xu
Xu, Xu, Xu, Uu^Vu, Uu, Uu, Uu, Cte, Ur, Ur, Uu^Tf, Cte, Xu, Ur, Ur, Uu^Tf, Uu^Tf, Xu, Xu, Xu, Xu, Xu
Xu, Xu, Xu, Uh, Uu^Tf, Uu, Xu, Uu, Ur, Uu^Vu, Uu, Uu, Xu, Xu, Uh, Ur, Ur, Xu, Uh, Xu, Uh, Xu
Xu, Xu, Uu^Vu, Uh, Uh, Uu^Vu, Xu, Uu, Ur, Uu, Uu^Tf, Xu, Xu, Xu, Uh, Uu^Tf, Ur, Uu^Tf, Uu, Uu^Vu, Uu^Tf, Uh
Xu, Xu, Xu, Uh, Xu, Xu, Ur, Ur, Uu^Vu, Uu^Tf, Uh, Uh, Xu, Xu, Uh, Uu^Vu, Xu, Ur, Ur, Ur, Ur, Uu
Xu, Xu, Xu, Xu, Xu, Xu, Ur, Uu, Uh, Uh, Uh, Uh, Xu, Xu, Xu, Uh, Xu, Xu, Xu, Uh, Uh, Ur
Xu, Xu, Xu, Xu, Xu, Ur, Uu, Xu, Xu, Xu, Xu, Xu, Xu, Xu, Xu, Xu, Xu, Xu, Xu, Xu, Xu, Uh
Xu, Xu, Xu, Xu, Xu, Ur, Uu, Xu, Xu, Xu, Xu, Xu, Xu, Xu, Xu, Xu, Xu, Xu, Xu, Xu, Xu, Xu
