Xu, Xu, Xu, Xu, Xu, Xu, Xu, Xu, Xu, Xu, Xu, Xu, Xu, Xu, Xu, Xu, Xu, Xu, Xu, Xu, Xu, Xu, Xu, Xu, Xu, Xu, Xu, Xu, Xu, Xu, Xu, Xu, Xu, Xu, Xu, Xu
Xu, Xu, Xu, Xu, Xu, Xu, Xu, Xu, Xu, Xu, Xu, Xu, Xu, Xu, Xu, Xu, Xu, Xu, Xu, Xu, Xu, Xu, Xu, Xu, Uh, Xu, Xu, Xu, Xu, Xu, Xu, Uu, Uu, Uu, Uu, Uu
Xu, Xu, Xu, Xu, Xu, Xu, Xu, Xu, Xu, Xu, Xu, Xu, Xu, Xu, Xu, Xu, Xu, Uh, Uh, Xu, Uu, Uu, Uu, Uu, Uu, Xu, Xu, Xu, Xu, Xu, Uu, Ur, Uu, Uu, Xu, Uu
Xu, Xu, Xu, Xu, Xu, Xu, Xu, Xu, Xu, Xu, Uh, Uh, Uu, Uu, Uu, Xu, Uh, Xu, Uu, Uu, Xu, Xu, Xu, Uu, Uu, Xu, Xu, Xu, Xu, Uu, Ur, Ur, Xu, Uu, Xu, Xu
Xu, Xu, Xu, Xu, Xu, Xu, Xu, Xu, Xu, Xu, Uu, Xu, Xu, Xu, Ur^Edt, Xu, Uh, Uu^Vc, Ur, Xu, Ur^Edt, Xu, Ur, Xu, Uu^Vc, Xu, Uu, Uu, Uu, Uu, Ur, Xu, Xu, Xu, Xu, Xu
Xu, Xu, Xu, Xu, Xu, Xu, Xu, Xu, Uu, Uu, Xu, Xu, Ur^Edt, Ur^Edt, Uu^Edt, Ur^Edt, Uu^Edt, Uu, Uu, Ur, Uu, Ur^Edt, Uu, Ur, Uu, Ur, Uu, 1 Kte, Cte, Ur, Uu, Uu, Xu, Xu, Xu, Xu
Xu, Xu, Xu, Xu, Xu, Uu, Uu, Uh, Xu, Uh, Uu, Xu, Ur^Ecf, Uu, Uu, Uu, Uu, Uu, Xu, Xu, Xu, Xu, Xu, Uu, Uh, Uu, Uu, Cte, Cte, Cte, Uu, Xu, Xu, Xu, Xu, Xu
Xu, Xu, Xu, Xu, Xu, Uu, Xu, Xu, Xu, Uh, Uh, Ur, Uu, Uu^Vc, Xu, Xu, Uu, Xu, Xu, Xu, Xu, Xu, Xu, Xu, Xu, Uh, Uu, Ur, Ur, 2 Kte, Uu, Xu, Xu, Xu, Xu, Xu
Xu, Xu, Xu, Xu, Uh, Uh, Xu, Xu, Uu, Uu, Ur^Edt, Uu, Uu, Uu, Uu, Uu, Xu, Xu, Xu, Xu, Xu, Xu, Xu, Xu, Xu, Xu, Uu, Uu, Ur, Uu, Xu, Uu, Xu, Xu, Xu, Xu
Xu, Xu, Xu, Xu, Xu, Uu, Uu, Uu^Tf, Ur, Ur^Edt, Xu, Uu, Xu, Xu, Xu, Xu, Xu, Xu, Ur, Ur, Uh, Xu, Xu, Xu, Xu, Xu, Uu, Ur, Uu^Vc, Xu, Xu, Uu, Xu, Xu, Xu, Xu
Xu, Xu, Xu, Xu, Xu, Xu, Uh, Uu^Vc, Ur^Ecf, Uu, Xu, Xu, Xu, Xu, Xu, Xu, Uh, Ur, Cer, Cer, Cer, Uh, Xu, Xu, Xu, Uu, Xu, Ur^Ecf, Uu, Xu, Xu, Uu, Uu, Xu, Xu, Xu
Xu, Xu, Uu, Uu, Uu, Uh, Uu, Ur, Uu, Xu, Xu, Xu, Xu, Xu, Xu, Xu, Uh^Vc, Ur^Edb, Cer, 5 Ket, Cer, Uu, Xu, Xu, Xu, Uu, Uu, Uu, Ur, Uh, Xu, Xu, Uu, Xu, Xu, Xu
Uu, Uh, Uu, Cer, Cer, Uh, Ur^Edt, Uu, Uh, Xu, Xu, Xu, Xu, Xu, Xu, Uh, Uu, Ur^Edb, Ur^Edb, Cer, Ur^Edb, Uu, Xu, Xu, Xu, Xu, Uu, Uu, Ur, Uh, Uu, Uu, Xu, Xu, Xu, Xu
Uu, Uu, Uu, 4 Ket, Cer, Ur^Edt, Ur, Uu, Qxu, Qxu, Qxu, Xu, Xu, Xu, Xu, Uh, Ur^Edb, Ur^Ecf, Uu, Ur, Uh, Xu, Xu, Xu, Xu, Xu, Uu, Uh, Uh, Ur^Vc, Xu, Xu, Xu, Xu, Xu, Xu
Xu, Xu, Uu, Cer, Ur^Edt, Ur^Edt, Uu^Vc, Uu, Qxu, Qxu, Xu, Xu, Xu, Xu, Xu, Uu, Ur, Ur^Edb, Uu, Uh^Vc, Xu, Xu, Xu, Xu, Uu, Xu, Uu, Uu, Ur^Ecf, Ur^Edt, Uu, Xu, Xu, Xu, Xu, Xu
Xu, Xu, Xu, Uu, Xu, Ur, Ur, Uu, Qxu, Qxu, Xu, Xu, Qxu, Xu, Xu, Uu, Uu, Xu, Xu, Xu, Xu, Xu, Xu, Xu, Uu, Uu, Uu, Ur^Edt, Xu, Uu^Edt, Uh, Xu, Uu, Xu, Xu, Xu
Xu, Xu, Xu, Xu, Xu, Xu, Uu, Ur^Ecf, Uh, Qxu, Qxu, Qxu, Qxu, Uu, Ur, Uu, Xu, Xu, Xu, Xu, Xu, Xu, Xu, Xu, Uh, Uu, Uu, Ur^Vc, Xu, Uu, Uu, Xu, Uu, Xu, Xu, Xu
Xu, Xu, Xu, Xu, Xu, Xu, Uh, Ur^Edt, Ur^Edt, Uh, Uu, Uu, Ur, Ur, Qxu, Uu, Xu, Xu, Xu, Xu, Xu, Xu, Xu, Xu, Ur^Vc, Uh, Xu, Uu, Uu, Uu^Tf, Xu, Uh, Xu, Xu, Xu, Xu
Xu, Xu, Xu, Xu, Xu, Xu, Xu, Uu, Uu^Tf, Uu, Xu, Ur^Edt, Uu, Qxu, Qxu, Xu, Xu, Xu, Qxu, Xu, Xu, Qxu, Qxu, Ur^Edt, Ur^Edt, Xu, Xu, Uu, Uh, Xu, Xu, Uh, Xu, Xu, Xu, Xu
Xu, Xu, Xu, Xu, Xu, Xu, Xu, Uu^Vc, Uu, Uu, Xu, Ur^Edt, Uu, Uh, Uu^Tf, Qxu, Qxu, Qxu, Qxu, Qxu, Qxu, Qxu, Uu, Ur^Edt, Cer, Ur^Edt, Ur, Uh, Xu, Xu, Uu, Uu, Xu, Xu, Xu, Xu
Xu, Xu, Xu, Xu, Xu, Xu, Xu, Xu, Xu, Uh, Uh, Xu, Uu, Ur, Ur^Vc, Uu, Ur, Uh, Uh, Uh, Uh, Uu, Ur^Edt, Ur^Edt, Cer, Cer, Cer, Uh, Uu, Uh, Xu, Xu, Xu, Xu, Xu, Xu
Xu, Xu, Xu, Xu, Xu, Xu, Xu, Xu, Xu, Uh^Vc, Uh, Uu^Tf, Uu^Tf, Uu, Uu, Ur, Uu, Ur^Ecf, Ur, Uu, Uu, Ur^Vc, Uu, Uu, Uu, 3 Ket, Uu, Uu, Xu, Uu, Xu, Xu, Xu, Xu, Xu, Xu
Xu, Xu, Xu, Xu, Xu, Xu, Xu, Xu, Xu, Xu, Xu, Xu, Xu, Xu, Xu, Xu, Xu, Uu, Xu, Uu, Xu, Uu, Xu, Xu, Xu, Uu, Uu, Xu, Xu, Xu, Xu, Xu, Xu, Xu, Xu, Xu
Xu, Xu, Xu, Xu, Xu, Xu, Xu, Xu, Xu, Xu, Xu, Xu, Xu, Xu, Xu, Xu, Xu, Xu, Xu, Xu, Xu, Xu, Xu, Xu, Xu, Xu, Uu^Tf, Uu, Xu, Xu, Xu, Xu, Xu, Xu, Xu, Xu
Xu, Xu, Xu, Xu, Xu, Xu, Xu, Xu, Xu, Xu, Xu, Xu, Xu, Xu, Xu, Xu, Xu, Xu, Xu, Xu, Xu, Xu, Xu, Xu, Xu, Xu, Xu, Uu, Xu, Xu, Xu, Xu, Xu, Xu, Xu, Xu
Xu, Xu, Xu, Xu, Xu, Xu, Xu, Xu, Xu, Xu, Xu, Xu, Xu, Xu, Xu, Xu, Xu, Xu, Xu, Xu, Xu, Xu, Xu, Xu, Xu, Xu, Xu, Uu, Uu, Xu, Xu, Xu, Xu, Xu, Xu, Xu
