Ww, Ww, Ww, Ww, Ds, Gg, Gg, Gg, Ss, Gg, Gll^Fp, Gll^Fp, Gll^Fp, Gll^Fp, Gll^Fp, Gll^Fp, Gll^Fp, Gg, Gg, Gg, Gg, Gg
Ww, Ww, Ww, Ds, Gg, Gg, Gg, Gg, Ss, Gll^Fp, Gll^Fp, Gll^Fp, Gll^Fp, Gll^Fp, Gg, Gg, Gg, Gg, Gg, Gg, Rr, Rr
Ww, Ww, Ww, Ds, Ww, Gg, Gg, Ss, Gg, Gg, Gg, Gg, Gg, Gg, Chr, Gg, Re, Re, Gs, Gg, Rr, Gg
Ww, Ww, Ds, Ww, Gg, Gg, Gg, Gg, Chr, Chr, Gg, Gs, Gs, Chr, Re^Es, Chr, Chr, Gs, Rr, Rr, Gg, Gg
Ds, Ds, Gg, Gg, Gs, Gg, Gg, Chr, Re^Es, Re^Es, Gs, Rp^Vhcr, Gs^Es, Re^Es, Re^Es, Re^Es, Re^Es, Re, Rr, Gg, Hh, Hh
Gg, Gg, Ss, Ss, Gs, Gs, Re, Re, Re^Es, Re, Gs, Gs, Rr, Gs, Gs, Re^Es, Rr^Es, Rr, Gg, Gd^Vhr, Hh, Hh
Hh, Hh, Gg, Gg, Chr, Gs, Hh, Hh, Hh, Gs^Es, Rr, Rr, Ch, Rr, Rr, Rr^Es, Re^Es, Re, Chr, Gg, Gll^Fp, Gll^Fp
Hh, Hh, Gg, Re, Chr, Hh, Gs, Rp^Vhcr, Hh, Hh, Rr, 2 Chr, 4 Khr, Ch, Rr, Re, Gs, Re, Chr, Gg, Gll^Fp, Gll^Fp
Hh, Hh, Re^Es, Re^Es, Re^Es, Hh, Rr, Gs, Gs, Gs, Rr, 1 Chr, Ch, Ch, Rr, Gs, Gs, Gs, Chr, Gg, Gg, Gll^Fp
Hh, Hh, Gg, Re^Es, Rr^Es, Rr^Es, Gs^Es, Rr^Es, Rr^Es, Rr, Re, Rr, Rr, Rr, Gs, Gs, Gll^Fp, Gs, Gg, Gg, Gll^Fp, Gll^Fp
Gg, Gg, Rr, Rr, Gs, Gs, Chr, Gs, Re, Re, Gs^Es, Gs, Re, Gs, Gg, Gll^Fp, Gll^Fp, Gll^Fp, Gll^Fp, Gll^Fp, Gll^Fp, Gll^Fp
Rr, Rr, Gd^Vhr, Gg, Gg, Gg, Gg, Chr, Re, Re, Re^Es, Gs, Gs, Re, Re, Gll^Fp, Gll^Fp, Gll^Fp, Gll^Fp, Gll^Fp, Gll^Fp, Gll^Fp
Gs, Gs, Gs, Gs, Gg, Gg, Gg, Re, Gg, Re^Es, Chr, Chr, Gg, Rp^Vhcr, Re, Gg, Re^Gvs, Gg, Gg, Gll^Fp, Gll^Fp, Gll^Fp
Gs, Gs, Hh, Gg, Hh, Gg, Gg, Gg, Gg, Chr, Gg, Gg, Re^Gvs, Gg, Re, Re^Gvs, Re^Gvs, Re^Gvs, Re^Gvs, Gg, Gll^Fp, Gg
Hh, Hh, 3 Hh, Hh, Hh, Gg, Hh, Hh, Gg, Gg, Gg, Re^Gvs, Re^Gvs, Re^Gvs, Re, Re^Gvs, Re^Gvs, Re^Gvs, Re^Gvs, Gg, Gg, Gg
Hh, Hh, Hh, Hh, Hh, Hh, Hh, Hh, Gg, Gg, Gg, Re^Gvs, Re^Gvs, Gg, Re, Gg, Gg, Re^Gvs, Gg, Gg, Gg, Gg
Hh, Hh, Hh, Hh, Hh, Hh, Hh, Hh, Hh, Gg, Gg, Gg, Gg, Gg, Gg, Re, Re, Gg, Gg, Gg, Gg, Gg
