Xu, Xu, Xu, Xu, Xu, Uu, Ur, Xu, Xu, Xu, Xu, Xu, Xu, Xu, Xu, Xu, Xu, Xu, Xu, Xu, Xu, Xu
Xu, Xu, Xu, Xu, Xu, 2 Uu, 1 Ur, Uu, Xu, Xu, Xu, Xu, Xu, Xu, Xu, Xu, Xu, Xu, Xu, Xu, Xu, Xu
Xu, Xu, Xu, Xu, Xu, Xu, Uu, Ur, Uh, Xu, Xu, Xu, Xu, Xu, Xu, Xu, Xu, Xu, Xu, Xu, Xu, Xu
Xu, Xu, Xu, Xu, Xu, Xu, Xu, Ur, Uu, Uh, Uh, Xu, Xu, Xu, Xu, Xu, Xu, Xu, Xu, Xu, Xu, Xu
Xu, Xu, Uh, Xu, Xu, Xu, Xu, Uu, Ur^Es, Uh, Uh, Xu, Uh, Xu, Xu, Xu, Xur, Xu, Xu, Xu, Xu, Xu
Uh, Uu, Uu^Vu, Xu, Xu, Xu, Xu, Xu, Ur^Es, Uh, Uu, Uu^Vu, Uu, Uu, Uh, Uh, Uh, Xur, Xu, Xu, Xu, Xu
Uh, Uu, Ur, Uu, Xu, Xu, Xu, Xu, Uu^Es, Ur^Es, Ur, Uu, Cte, Uu, Uu, Gg^Tf, Uh, Xur, Xu, Xu, Xu, Uu
Uh, Uh, Uu^Es, Ur, Xu, Xu, Xur, Xur, Uu^Es, Uu^Es, Ur, Cte, 3 Kte, Cte, Uu, Uu^Emf, Uu, Xur, Uh, Xu, Uh, Uh
Xu, Uu, Uu^Es, Ur^Es, Uu, Uh, Uh, Uh, Uu, Ur, Ur, Cte, Cte^Es, Cte^Es, Ur, Ur, Ur^Es, Uu^Es, Uu, Uu^Vu, Uh, Uh
Xu, Xu, Xu, Ur^Es, Ur^Es, Uu, Uu, Ur, Ur, Ur, Ur, Ur, Uu, Cte^Es, Uu, Uu, Uu^Es, Ur^Es, Uu^Es, Uu^Es, Uu^Es, Uh
Xu, Xu, Uh, Uu, Uu, Uu, Uu^Vu, Uu, Uu, Ur, Uh, Uu, Uu, Uu, Uu, Uu, Uu, Uu, Uu, Uu^Es, Uu^Es, Uu
Xu, Uh, Uu^Tf, Uu, Uh, Xu, Xu, Xu, Uu, Ur, Uu, Uu, Wwg^Es, Wwg^Es, Wwg^Es, Wwg^Es, Xu, Uh^Em, Uh, Uu^Vu, Xur, Xu
Uu, Uh, Uu^Em, Uu^Emf, Xu, Xu, Xur, Uh, Uu, Ur^Es, Uu, Uu^Vu, Xu, Wwg^Es, Wwg, Wwg^Es, Xu, Uu^Tf, Uh, Uh, Xu, Xu
Uu, Uu, Ur, Uu^Vu, Xu, Xur, Uh, Uh, Ur^Es, Ur^Es, Uh, Uh, Xu, Xu, Wwg, Wwg, Wwg, Xu, Xu, Xu, Xu, Xu
Ur, Ur, Xu, Xu, Xu, Xur, Uh, Uu, Uu, Uu, Uu, Uh, Uh, Xu, Xu, Xu, Xu, Xu, Xu, Xu, Xu, Xu
Uu, Uu, Uu, Uu, Uu, Uu^Em, Uu^Tf, Uu^Em, Xu, Uu, Uu, Uu^Vu, Xu, Xu, Xu, Xu, Xu, Xu, Xu, Xu, Xu, Xu
Uu, Uu, Uu, Uu, Xu, Xu, Xu, Xu, Uu, Uu, Uu, Uu, Xu, Xu, Uu, Xu, Uu, Xu, Xu, Xu, Uu, Xu
