Xu, Xu, Xu, Xu, Xu, Xu, Xu, Xu, Ur, Ur, Uh, Uu, Xu, Xu, Xu, Xu, Xu, Xu, Xu, Xu, Xu, Xu, Xu, Xu, Xu
Xu, Xu, Xu, Xu, Xu, Xu, Xu, Ur, Uu, Uu, Xu, Xu, Xu, Xu, Xu, Xu, Xu, Xu, Xu, Xu, Xu, Xu, Xu, Xu, Xu
Xu, Xu, Xu, Xu, Cud, 4 Kud, Cud, Ur, Uu^Ii, Uu, Xuc, Xu, Xu, Xu, Xu, Xu, Xu, Xu, Xu, Xu, Xu, Xu, Xu, Xu, Xu
Xu, Xu, Xu, Uu, Ur, Cud, Ur, Ur, Uu^Ii, Uu^Tf, Uu, Xuc, Uh, Xu, Xu, Xu, Xu, Xu, Xu, Xu, Xu, Xu, Xu, Xu, Xu
Xu, Xu, Uh, Uu, Ur, Ur, Xuc, Ur^Ii, Ur, Uu^Ii, Xu, Uu, Uu, Uh^Vud, Uh, Xu, Xuc, Xu, Uh, Xu, Xu, Xu, Xu, Xu, Xu
Xu, Xu, Uu^Vud, Uh, Ur, Uu, Xuc, Xu, Uu, Ur, Xu, Uu^Tf, Xu, Uu, Uu, Uh, Uu, Xuc, Ur, Uh^Vud, Xu, Xu, Xu, Xu, Xu
Xu, Xu, Xu, Uu, Ur^Ii, Uu^Ii, Xu, Xu, Xu, Ur^Ii, Uu^Tfi, Xu, Uu, Uu, Uu^Tf, Xu, Xu, Uu, Ur, Uu, Uu, Xu, Xu, Xu, Xu
Xu, Xu, Xu, Uu, Ur, Uu, Xuc, Xu, Uu^Tf, Uu^Tf, Uu^Tf, Ur, Ur, Xu, Xu, Xu, Uu^Tf, Ur, Uh, Uh, Xuc, Xu, Xu, Xu, Xu
Xu, Xu, Xu, Xu, Uh, Uu, Ur, Uu, Xu, Uu^Vu, Xuc, Uu, Ur, Xu, Xu, Xu, Xu, Uu, Uu^Vud, Xuc, Xu, Xu, Xu, Xu, Xu
Xu, Xu, Xu, Xu, Uh, Uu, Uu, Ur, Ww, Xu, Xu, Xuc, Xuc, Ur, Ur, Xu, Xu, Uh, Uu, Xu, Xu, Xu, Xu, Xu, Uu
Xu, Xu, Xu, Xu, Xu, Cud, Ww, Ww, Wwr, Xu, Xu, Xu, Xu, Uu, Ur, Xu, Xu, Uu, Kud, Xu, Uu, Xu, Xuc, Uu, Ur
Xu, Xu, Xu, Xu, Xu, Kud, Wwr, Uu, Xu, Ww, Wwr, Wwr, Wwr, Ww, Ww, Ur, Uu^Vud, Uu, Uu, Cud, Ur, Xuc, Ur, Ur, Xu
Xu, Xu, Xu, Xu, Xu, Xu, Wwr, Xu, Xu, Ww^Es, Wwr, Xu, Xu, Ww, Ww, Ur, Ur, Ur, Uh, Ur, Uu, Ur, Uu, Xu, Xu
Xu, Xu, Xu, Xu, Xu, Xu, Xu, Ww, Ww, Ww^Es, Ww^Es, Xu, Xu, Ww, Ww, Ur, Uu, Uh, Xu, Uu, Uu^Vu, Uu, Xu, Xu, Xu
Xu, Xu, Xu, Xu, Uh, Uh, Uu^Tf, Uu^Tf, Uh^Vu, Ww^Es, Ww^Es, Uh, Uu^Vud, Xu, Xu, Ur, Uu, Xu, Xu, Uu, Xu, Xu, Xu, Xu, Xu
Xu, Xu, Xu, Xu, Uh, Xu, Uu, Uu^Em, Xu, Ww, Uh, Uh, Uu, Uh, Uu, Uu, Uu, Xu, Xu, Uh, Uu, Xu, Xu, Xu, Xu
Xu, Xu, Xu, Xu, Uu, Xu, Uu, Uh, Xu, Uu^Tf, Xu, Xu, Uu, Uh, Xu, Uu, Xu, Xu, Xu, Xu, Ur, Xu, Xu, Xu, Xu
Xu, Xu, Xu, Uu^Tf, Uu^Tf, Uu, Uu, Xu, Xu, Uu^Em, Uu, Xu, Xu, Xu, Uh, Ur, Uh, Xu, Xu, Xu, Ur, Xu, Xu, Xu, Xu
Xu, Xu, Xu, Uu^Tf, Uu^Em, Uu, Uu, Uu^Vu, Uu, Uh, Uu^Vu, Uu, Uu, Uh^Vu, Ur, Ur, Uu, Xu, Xu, Uu^Tf, Xu, Xu, Xu, Xu, Xu
Xu, Xu, Xu, Xu, Cte, Cte, Cte^Es, Ur, Ur, Uh, Xu, Uu, Ur, Ur, Uu, Ur, Ur, Uu^Vu, Uu, Uu, Uh, Xu, Xu, Xu, Xu
Xu, Xu, Xu, Xu, Xu, 3 Kte, Cte^Es, Uu, Ur, Uu, Uu^Vu, Uh, Ur, Uh, Xu, Xu, Xu, Ur, Ur, Uu, Cte, Uh, Uh, Xu, Xu
Xu, Xu, Xu, Xu, Xu, Cte, Uu, Uu, Ur, Uu, Uu^Tf, Xu, Ur, Uh, Uh, Xu, Xu, Uu, Cte, Cte, 2 Kte, Cte, Uh, Xu, Xu
Xu, Xu, Xu, Xu, Xu, Xu, Xu, Uh, Uu, Ur, Ur, Ur, Uu, Uh, Uh^Vu, Uh, Uu, Uu, Cte, 1 Kte, Cte, Cte, Uh, Xu, Xu
Xu, Xu, Xu, Xu, Xu, Xu, Xu, Uh, Xu, Uh, Uh, Xu, Xu, Uh, Xu, Uu, Xu, Uu, Uu, Cte, Ur, Uu, Xu, Xu, Xu
Xu, Xu, Xu, Xu, Xu, Xu, Xu, Xu, Xu, Xu, Xu, Xu, Xu, Xu, Xu, Xu, Xu, Xu, Xu, Uu, Ur, Uu, Xu, Xu, Xu
Xu, Xu, Xu, Xu, Xu, Xu, Xu, Xu, Xu, Xu, Xu, Xu, Xu, Xu, Xu, Xu, Xu, Xu, Xu, Xu, Xu, Ur, Ur, Xu, Xu
