Xu, Xu, Xu, Xu, Xu, Xu, Xu, Xu, Uu, Ur, Uh, Uu, Xu, Xu, Xu, Xu, Xu, Xu, Xu, Xu, Xu, Xu, Xu, Xu, Xu
Xu, Xu, Xu, Xu, Xu, Xu, Xu, Uh, Ur, Ur, Xu, Xu, Xu, Xu, Xu, Xu, Xu, Xu, Xu, Xu, Xu, Xu, Xu, Xu, Xu
Xu, Xu, Xu, Xu, Cud, 4 Kud, Cud, Uh, Ur, Uu, Xuc, Xu, Xu, Xu, Xu, Xu, Xu, Xu, Xu, Xu, Xu, Xu, Xu, Xu, Xu
Xu, Xu, Xu, Uu, Uu, Cud, Ur, Ur, Uu^Ii, Uu, Uu, Xuc, Uh, Xu, Xu, Xu, Xu, Xu, Uh, Xu, Xu, Xu, Xu, Xu, Xu
Xu, Xu, Uh, Uh, Ur, Ur, Xuc, Uu, Uu, Uu^Ii, Xu, Uu, Uu, Uh^Vud, Xu, Xu, Xuc, Xu, Uu, Xu, Xu, Xu, Xu, Xu, Xu
Xu, Xu, Uh^Vud, Uh, Uu, Uu, Xuc, Xu, Uh, Uu, Xu, Uu, Xu, Uu, Uu, Ur, Uu^Ii, Xuc, Uu, Uu^Vud, Xu, Xu, Xu, Xu, Xu
Xu, Xu, Xu, Uu, Ur, Uh^Vud, Xu, Xu, Xu, Uu, Ur, Xu, Ur, Ur, Uu, Xu, Xu, Uu^Ii, Ur, Uu, Uh, Xu, Xu, Xu, Xu
Xu, Xu, Xu, Uu, Ur, Uh, Xuc, Xu, Uu, Ur, Uu^Ii, Uu^Ii, Ur, Xu, Xu, Xu, Uh, Uh, Ur, Uu, Xuc, Xu, Xu, Xu, Xu
Xu, Xu, Xu, Xu, Tb^Tf, Ur, Ur, Uu, Xu, Uh^Vu, Xuc, Uu^Ii, Uu^Ii, Xu, Xu, Xu, Xu, Ur, Uu^Vud, Xuc, Xu, Xu, Xu, Xu, Xu
Xu, Xu, Xu, Xu, Uu^Tf, Tb^Tf, Uu, Uu, Ww, Xu, Xu, Xuc, Xuc, Ur, Ur, Xu, Xu, Ur, Uh, Xu, Xu, Xu, Xu, Xu, Uu
Xu, Xu, Xu, Xu, Xu, Xu, Uu, Ww, Ww, Xu, Xu, Xu, Xu, Uu^Tf, Uu, Xu, Xu, Uu, Kud, Xu, Uh, Xu, Xuc, Ur, Uu
Xu, Xu, Xu, Xu, Xu, Xu, Xu, Uh^Vu, Xu, Ww, Wwr, Wwr, Wwr, Ww, Ww, Uu, Uh^Vud, Ur, Uu, Cud, Uh, Xuc, Ur, Ur, Xu
Xu, Xu, Xu, Xu, Xu, Xu, Xu, Xu, Xu, Ww, Wwr, Xu, Xu, Ww, Ww, Ur, Ur, Ur, Uu, Uh, Uu, Ur, Uu, Xu, Xu
Xu, Xu, Xu, Xu, Xu, Xu, Xu, Xu, Ww, Ww, Ww, Xu, Xu, Ww, Ww, Ur, Uu, Ur, Xu, Uu, Uh^Vu, Uu, Xu, Xu, Xu
Xu, Xu, Xu, Xu, Uu, Uu, Uu, Uh, Uh^Vu, Ww, Ww, Uh, Uu, Xu, Xu, Ur, Uu^Tf, Xu, Xu, Uu, Xu, Xu, Xu, Xu, Xu
Xu, Xu, Xu, Xu, Uh, Xu, Ur, Ur, Xu, Ww, Uu, Uh, Uh, Uh, Uu, Ur, Uu^Tf, Xu, Xu, Uh, Uu, Xu, Xu, Xu, Xu
Xu, Xu, Xu, Xu, Uh, Xu, Ur, Uu, Xu, Uu^Tf, Xu, Xu, Uu, Uh, Xu, Uu, Xu, Xu, Xu, Xu, Uu, Xu, Xu, Xu, Xu
Xu, Xu, Xu, Uu, Uu, Uu, Uu, Xu, Xu, Uu, Uu, Xu, Xu, Xu, Uh, Ur, Uh, Xu, Xu, Xu, Ur, Xu, Xu, Xu, Xu
Xu, Xu, Xu, Uu, Uu, Uu, Ur, Uh^Vu, Uh, Uh, Uh^Vu, Uu, Ur, Uh^Vu, Ur, Ur, Uh, Xu, Xu, Ur, Xu, Xu, Xu, Xu, Xu
Xu, Xu, Xu, Xu, Cte, Cte, Cte, Ur, Ur, Uu, Xu, Ur, Ur, Ur, Uu, Uu, Uu, Uh^Vu, Uu, Uu^Tf, Xu, Xu, Xu, Xu, Xu
Xu, Xu, Xu, Xu, Cte, 3 Kte, Cte, Uu, Uu, Uu, Uh^Vu, Uu, Ur, Uu, Xu, Xu, Xu, Ur, Uu, Uu, Uu, Xu, Xu, Xu, Xu
Xu, Xu, Xu, Xu, Xu, Xu, Uu, Uu, Uu, Uh, Uu, Xu, Ur, Uh, Uu, Xu, Xu, Ur, Cte, Cte, 2 Kte, Uh, Xu, Xu, Xu
Xu, Xu, Xu, Xu, Xu, Xu, Xu, Uu, Ur, Uh, Ur, Ur, Uu, Uh, Uh^Vu, Uu, Uh, Uu, 1 Kte, Cte, Cte, Uu, Xu, Xu, Xu
Xu, Xu, Xu, Xu, Xu, Xu, Xu, Uu, Xu, Ur, Uu, Xu, Xu, Uu, Xu, Uu, Xu, Uu, Uu, Cte, Uh, Uh, Xu, Xu, Xu
Xu, Xu, Xu, Xu, Xu, Xu, Xu, Xu, Xu, Xu, Xu, Xu, Xu, Xu, Xu, Xu, Xu, Xu, Xu, Ur, Ur, Uh, Xu, Xu, Xu
Xu, Xu, Xu, Xu, Xu, Xu, Xu, Xu, Xu, Xu, Xu, Xu, Xu, Xu, Xu, Xu, Xu, Xu, Xu, Xu, Xu, Ur, Ur, Xu, Xu
