Xu, Xu, Xu, Xu, Xu, Xu, Xu, Xu, Uu, Ur, Uh, Uu, Xu, Xu, Xu, Xu, Xu, Xu, Xu, Xu, Xu, Xu, Xu, Xu, Xu
Xu, Xu, Xu, Xu, Xu, Xu, Xu, Uh, Ur, Ur, Xu, Xu, Xu, Xu, Xu, Xu, Xu, Xu, Xu, Xu, Xu, Xu, Xu, Xu, Xu
Xu, Xu, Xu, Xu, Cud, 5 Kud, Cud, Uh, Ur, Uu, Xuc, Xu, Xu, Xu, Xu, Xu, Xu, Xu, Xu, Xu, Xu, Xu, Xu, Xu, Xu
Xu, Xu, Xu, Uu, Cud, Cud, Ur, Ur, Uu^Ii, Uu, Uu, Xuc, Uh, Xu, Xu, Xu, Xu, Xu, Uh, Xu, Xu, Xu, Xu, Xu, Xu
Xu, Xu, Uh, Uh, Ur, Ur, Xuc, Uu, Uu, Uu^Ii, Xu, Uu, Uu, Uu^Vud, Xu, Xu, Xuc, Xu, Uu, Xu, Xu, Xu, Xu, Xu, Xu
Xu, Xu, Uu^Vud, Uh, Uu, Uu, Xuc, Xu, Uh, Uu, Xu, Uu, Xu, Uu, Uu, Ur, Uu^Ii, Xuc, Uu, Uu^Vu, Xu, Xu, Xu, Xu, Xu
Xu, Xu, Xu, Uu, Ur, Uu^Vud, Xu, Xu, Xu, Uu, Ur, Xu, Ur, Ur, Uu, Xu, Xu, Uu^Ii, Ur, Uu, Uh, Xu, Xu, Xu, Xu
Xu, Xu, Xu, Uu, Ur, Uh, Xuc, Xu, Uu, Ur, Uu^Ii, Uu^Ii, Ur, Xu, Xu, Xu, Uh, Uh, Ur, Uu, Xu, Xu, Xu, Xu, Xu
Xu, Xu, Xu, Xu, Tb^Tf, Ur, Ur, Uu, Xu, Uu^Vu, Xuc, Uu^Ii, Uu^Ii, Xu, Xu, Xu, Xu, Ur, Uu^Vu, Xu, Xu, Xu, Xu, Xu, Xu
Xu, Xu, Xu, Xu, Uu^Tf, Tb^Tf, Uu, Uu, Wwg, Xu, Xu, Xuc, Xuc, Uu, Uu, Xu, Xu, Ur, Uh, Xu, Xu, Xu, Xu, Xu, Uu
Xu, Xu, Xu, Xu, Xu, Xu, Uu, Wwg, Wwg, Xu, Xu, Xu, Xu, Uu^Tf, Uu, Xu, Xu, Uu, Uh, Xu, 4 Kte, Xu, Xu, Ur, Uu
Xu, Xu, Xu, Xu, Xu, Xu, Xu, Uu^Vu, Xu, Wwg, Wwrg, Wwg, Wwrg, Wwg, Wwg, Uu, Uu^Vu, Ur, Uu, Cte^Es, Cte, Xu, Ur, Ur, Xu
Xu, Xu, Xu, Xu, Xu, Xu, Xu, Xu, Xu, Wwg, Wwg, Xu, Xu, Wwg, Wwrg, Ur, Ur, Ur, Uu, Cte^Es, Uu, Ur, Uu, Xu, Xu
Xu, Xu, Xu, Xu, Xu, Xu, Xu, Xu, Uh, Uu, Uu, Xu, Xu, Wwg, Wwg, Ur, Uu, Ur, Xu, Uu, Uu^Vu, Uu, Xu, Xu, Xu
Xu, Xu, Xu, Xu, Uu, Uu, Uu, Uh, Uu^Vu, Ur, Ur, Uu^Ii, Ur^Ii, Wwrg, Uu^Vu, Ur, Uu^Tf, Xu, Xu, Uu, Xu, Xu, Xu, Xu, Xu
Xu, Xu, Xu, Xu, Uh, Xu, Ur, Ur, Xu, Uu, Ur, Ur^Ii, Uh, Ur^Ii, Uu, Ur, Uu^Tf, Xu, Xu, Uh, Uu, Xu, Xu, Xu, Xu
Xu, Xu, Xu, Xu, Uh, Xu, Ur, Uu, Xu, Ur, Xu, Xu, Xu, Uh, Xu, Uu, Xu, Xu, Xu, Xu, Uu, Xu, Xu, Xu, Xu
Xu, Xu, Xu, Xu, Uu, Uu, Uu, Xu, Xu, Uu, Xu, Xu, Xu, Xu, Uh, Uu, Uh, Xu, Xu, Xu, Ur, Xu, Xu, Xu, Xu
Xu, Xu, Xu, Xu, Xu, Uh, Ur, Uu^Vu, Uh, Uh, Uu^Vu, Uu, Ur, Uu^Vu, Ur, Ur, Uh, Xu, Xu, Ur, Xu, Xu, Xu, Xu, Xu
Xu, Xu, Xu, Xu, Xu, Uh, Uu, Ur, Ur, Uu, Uu, Ur, Uu, Ur, Uu, Uu, Uu, Uu^Vu, Uu, Uu^Tf, Xu, Xu, Xu, Xu, Xu
Xu, Xu, Xu, Xu, Xu, Xu, Uu, Cte, Cte^Es, Uu, Uu^Vu, Xu, Uu, Uu, Xu, Xu, Xu, Ur, Uu, Uu, Uu, Xu, Xu, Xu, Xu
Xu, Xu, Xu, Xu, Xu, Xu, Uu, 3 Kte, Cte^Es, Uh, Uu, Xu, Xu, Uh, Uu, Xu, Xu, Ur, Cte, Cte, 2 Kte, Uh, Xu, Xu, Xu
Xu, Xu, Xu, Xu, Xu, Xu, Xu, Uu, Uu, Uh, Uu, Uh, Uu, Uh, Uu^Vu, Uu, Uh, Uu, 1 Kte, Cte, Cte, Uu, Xu, Xu, Xu
Xu, Xu, Xu, Xu, Xu, Xu, Xu, Uu, Xu, Uu, Uu, Xu, Xu, Uu, Xu, Uu, Xu, Uu, Uu, Cte, Uh, Uh, Xu, Xu, Xu
Xu, Xu, Xu, Xu, Xu, Xu, Xu, Xu, Xu, Xu, Xu, Xu, Xu, Xu, Xu, Xu, Xu, Xu, Xu, Ur, Ur, Uh, Xu, Xu, Xu
Xu, Xu, Xu, Xu, Xu, Xu, Xu, Xu, Xu, Xu, Xu, Xu, Xu, Xu, Xu, Xu, Xu, Xu, Xu, Xu, Xu, Ur, Ur, Xu, Xu
