Cte, Mm, Mm, Mm, Mm, Mm, Mm, Mm, Mm, Mm, Mm, Mm, Mm, Mm, Mm, Mm, Mm, Mm, Mm, Mm, Mm, Mm, Mm, Mm, Mm, Mm, Mm, Mm, Mm, Mm, Mm, Mm, Mm, Mm, Mm, Mm, Mm, Mm, Mm, Mm, Mm, Mm, Mm, Mm, Cte, Cte, Cte
Cte, 3 Kte, Mm, Mm, Mm, Mm, Mm, Mm, Mm, Mm, Mm, Mm, Mm, Mm, Mm, Mm, Mm, Mm, Mm, Mm, Mm, Mm, Mm, Mm, Mm, Mm, Mm, Mm, Mm, Mm, Mm, Mm, Mm, Mm, Mm, Mm, Mm, Mm, Mm, Mm, Mm, Mm, Mm, Mm, Cte^Es, 4 Kte, Cte
Cte, Cte^Es, Mm, Mm, Mm, Mm, Mm, Mm, Mm, Mm, Mm, Mm, Mm, Mm, Mm, Mm, Mm, Mm, Mm, Mm, Mm, Mm, Mm, Mm, Mm, Mm, Mm, Mm, Mm, Mm, Mm, Mm, Mm, Mm, Mm, Mm, Mm, Mm, Mm, Mm, Mm, Mm, Mm, Mm, Mm, Cte^Es, Cte
Mm, Cte^Es, Mm, Mm, Mm, Mm, Mm, Mm, Mm, Mm, Mm, Mm, Mm, Mm, Mm, Mm, Mm, Mm, Mm, Mm, Mm, Mm, Mm, Mm, Mm, Mm, Mm, Mm, Mm, Mm, Mm, Mm, Mm, Mm, Mm, Mm, Mm, Mm, Mm, Mm, Mm, Mm, Mm, Mm, Mm, Mm, Mm
Mm, Mm, Mm, Mm, Mm, Mm, Mm, Mm, Mm, Mm, Mm, Mm, Mm, Mm, Mm, Mm, Mm, Mm, Mm, Mm, Mm, Mm, Mm, Mm, Mm, Mm, Mm, Mm, Mm, Mm, Mm, Mm, Mm, Mm, Mm, Mm, Mm, Mm, Mm, Mm, Mm, Mm, Mm, Mm, Mm, Mm, Mm
Mm, Mm, Mm, Mm, Mm, Mm, Mm, Mm, Mm, Mm, Mm, Mm, Mm, Mm, Mm, Mm, Mm, Mm, Mm, Mm, Mm, Mm, Mm, Mm, Mm, Mm, Mm, Mm, Mm, Mm, Mm, Mm, Mm, Mm, Mm, Mm^Vo, Mm, Mm, Mm, Mm, Mm, Mm, Mm, Mm, Mm, Mm, Mm
Mm, Mm, Mm, Mm, Mm, Mm, Mm, Mm, Mm, Mm, Mm, Mm, Mm, Mm, Mm, Mm, Mm, Mm, Mm, Mm, Mm, Mm, Mm, Mm, Mm, Mm, Mm, Mm, Mm, Mm, Mm, Mm, Mm, Mm, Mm, Mm, Mm, Mm, Mm, Mm, Mm, Mm, Mm, Mm, Mm, Mm, Mm
Mm, Mm, Mm, Mm, Mm, Mm, Mm, Mm, Mm, Mm, Mm, Mm, Mm, Mm, Mm, Mm, Mm, Mm, Mm, Mm, Mm, Mm, Mm, Mm, Mm, Mm, Mm, Mm, Mm, Mm, Mm, Mm, Mm, Mm, Mm, Mm, Mm, Mm, Mm, Mm, Mm, Mm, Mm, Mm, Mm, Mm, Mm
Mm, Mm, Mm, Mm, Mm, Mm, Mm, Mm^Vo, Mm, Mm, Mm, Mm, Mm, Mm, Mm, Mm, Mm, Mm, Mm, Mm, Mm, Mm, Mm, Mm, Mm, Mm, Mm, Mm, Mm, Mm, Mm, Mm, Mm, Mm, Mm, Mm, Mm, Mm, Mm, Mm, Mm, Mm^Vo, Mm, Mm, Mm, Mm, Mm
Mm, Mm, Mm, Mm, Mm, Mm, Mm, Mm, Mm, Mm, Mm, Mm, Mm, Mm, Mm, Mm, Mm, Mm, Mm, Mm, Mm, Mm^Vo, Mm, Mm, Mm, Mm, Hh, Hh, Hh^Fp, Hh^Fp, Mm, Mm, Mm, Mm, Mm, Mm, Mm, Mm, Mm, Mm, Mm, Mm, Mm, Mm, Mm, Mm, Mm
Mm, Mm, Mm, Mm, Mm, Mm, Mm, Mm, Mm, Mm, Mm, Mm, Mm, Mm, Mm, Mm, Mm, Mm, Mm, Mm, Mm, Mm, Mm, Hh^Fp, Hh, Hh, Mm, Hh, Hh, Hh, Mm, Mm, Mm^Vo, Mm, Mm, Mm, Mm, Mm, Mm, Mm, Mm, Mm, Mm, Mm, Mm, Mm, Mm
Mm, Mm, Mm, Mm, Mm, Mm, Mm, Mm, Mm, Mm, Mm, Mm, Mm, Mm, Mm^Vo, Mm, Mm, Mm, Mm, Mm, Mm, Mm, Mm, Hh, Hh, Mm, Mm, Mm, Hh, Hh^Fp, Mm, Mm, Mm, Mm, Mm, Mm, Mm, Mm, Mm, Mm, Mm, Mm, Mm, Mm, Mm, Mm, Mm
Mm, Mm, Mm, Mm, Mm, Mm, Mm, Mm, Mm, Mm, Mm, Mm, Mm, Mm, Mm, Mm, Mm, Mm, Mm, Mm, Mm, Mm, Mm, Mm, Hh^Fp, Hh, Hh, Hh, Mm, Mm, Hh, Mm, Mm, Mm, Mm, Mm, Mm, Mm, Mm, Mm, Mm, Mm, Mm, Mm, Mm, Mm, Mm
Mm, Mm, Mm, Mm, Mm, Mm, Mm, Mm, Mm, Mm, Mm, Mm, Mm, Mm, Mm, Mm, Mm, Mm, Mm, Mm, Mm, Mm, Mm, Hh^Fp, Mm, Mm, Mm, Hh, Mm, Mm, Mm, Mm, Mm, Mm, Mm, Mm, Mm, Mm, Mm, Mm, Mm, Mm, Mm, Mm, Mm, Mm, Hh
Mm, Mm, Mm, Mm, Mm, Mm, Mm^Vo, Mm, Mm, Mm, Mm, Mm, Mm, Mm, Mm, Mm, Mm, Mm, Mm, Mm, Mm, Mm, Mm, Mm, Mm, Mm, Mm, Mm, Mm, Mm, Mm, Mm, Mm, Mm, Mm, Mm, Mm, Mm, Hh, Hh, Mm, Mm, Hh, Mm, Hh, Hh, Gd
Mm, Mm, Mm, Mm, Mm, Mm, Mm, Mm, Mm, Mm, Mm, Mm, Hh, Mm, Mm, Mm, Mm, Mm, Mm, Mm, Mm, Mm, Mm, Mm, Mm, Mm, Mm, Mm, Mm, Mm, Hh, Mm, Hh, Hh, Mm, Mm, Mm, Mm, Gd^Fp, Hh, Hh, Mm, Hh, Hh^Vo, Hh, Gd, Gd
Mm, Mm, Mm, Mm, Mm, Mm, Mm, Mm, Mm, Mm, Mm, Mm, Hh, Mm, Mm, Mm, Mm, Mm, Mm, Mm, Hh, Mm, Hh, Hh^Vo, Mm, Mm, Mm, Mm, Mm, Hh, Hh^Vo, Hh, Hh, Hh, Mm, Mm, Hh, Hh, Gd^Fp, Gd^Fp, Gd^Fmw, Gd^Fp, Gd^Fp, Hh, Gd, Gd, Gd
Mm, Hh, Mm, Mm, Mm, Mm, Mm, Mm, Mm, Mm, Mm, Hh, Hh^Fp, Hh^Vo, Mm, Mm, Hh, Hh, Hh, Hh, Hh, Hh, Hh, Hh, Mm, Mm, Mm, Mm, Hh^Fp, Hh, Hh, Hh, Hh, Mm, Hh, Hh, Gd, Gd^Fmw, Gd^Fp, Gd^Fp, Gd^Fp, Gd^Fp, Gd, Gd, Gd, Gd, Gd
Mm, Hh, Hh, Mm, Mm, Mm, Mm, Mm, Hh, Mm, Mm, Hh, Hh, Hh, Hh, Hh^Fp, Gd^Fp, Hh^Fp, Hh, Hh^Fp, Gd, Gd, Gd, Hh, Hh, Mm, Mm, Mm, Hh, Hh, Mm, Mm, Mm, Hh, Hh, Gd, Hh, Gd, Gd, Gd, Gd, Gd, Gd^Fmw, Gd, Gd, Gd, Mm
Xu, Hh, Hh, Hh^Vo, Hh, Hh, Hh, Hh, Hh, Hh, Hh, Hh^Fp, Gd^Fmw, Hh^Fp, Hh, Gd^Fp, Gd^Fp, Gd^Fmw, Hh^Fp, Hh, Hh^Vo, Hh, Gd^Fp, Gd, Gd^Es, Gd, Gd, Gd, Hh^Fp, Hh^Fp, Mm, Mm, Mm, Mm, Hh^Vo, Hh, Gd, Gd, Mm, Gd, Gd^Fp, Gd^Fp, Gd^Fp, Gd^Fp, Hh^Fp, Mm, Mm
Xu, Hh, Hh, Hh, Re^Es, Hh, Gd, Gd, Gd, Gd, Gd^Fp, Gd^Fp, Gd^Fp, Gd^Fp, Gd, Gd, Gd, Gd^Es, Gd, Hh, Mm, Gd^Fp, Gd^Fp, Gd^Fet, Gd^Fmw, Gd^Fp, Gd^Fp, Hh, Mm, Mm, Mm, Mm, Hh, Hh, Hh, Hh, Hh, Mm, Mm, Mm, Hh^Fmw, Hh^Fp, Hh^Fp, Hh^Fp, Hh^Fp, Mm, Mm
Uu, Uu, 1 Kte, Cte, Re^Es, Re^Es, Re, Re, Gd, Gd, Gd, Gd, Gd, Gd, Gd^Fp, Gd^Fp, Mm, Hh, Hh, Hh, Mm, Hh^Fp, Hh, Gd^Fp, Hh, Gd^Fp, Hh^Fp, Hh, Hh, Hh, Hh, Hh, Mm, Mm, Mm, Mm, Mm, Mm, Mm, Mm, Mm, Mm, Mm, Hh^Fp, Mm, Mm, Mm
Uu, Uu, Cte, Cte, Cte, Re, Re^Es, Gd, Hh^Vo, Gd, Hh, Hh, Hh, Hh, Hh^Fmw, Hh, Mm, Mm^Vo, Mm, Mm, Mm, Mm, Hh^Fp, Hh, Mm, Hh^Fp, Mm, Mm, Mm, Mm, Hh, Mm, Mm, Mm, Mm, Mm, Mm, Mm, Mm, Mm^Vo, Mm, Mm, Mm, Mm, Mm, Mm, Mm
Uu, Uu, Ur, 2 Kte, Uu, Xu, Mm, Hh, Mm, Mm, Mm, Mm, Mm, Hh^Fp, Mm, Mm, Mm, Mm, Mm, Mm, Mm, Mm, Mm, Hh, Mm, Mm, Mm, Mm, Mm, Mm, Mm, Mm, Mm, Mm, Mm, Mm, Mm, Mm, Mm, Mm, Mm, Mm, Mm, Mm, Mm, Mm, Mm
Ur, Ur, Uu, Uu, Xu, Xu, Xu, Mm, Mm, Mm, Mm, Mm, Mm, Mm, Mm, Mm, Mm, Mm, Mm, Mm, Mm, Mm, Mm, Mm, Mm, Mm, Mm, Mm, Mm, Mm, Mm, Mm, Mm, Mm, Mm, Mm, Mm, Mm, Mm, Mm, Mm, Mm, Mm, Mm, Mm, Mm, Mm
