Xu, Xu, Xu, Xu, Xu, Xu, Xu, Xu, Xu, Xu, Xu, Xu, Ur, Uu, Xu, Xu, Xu, Xu, Xu, Xu, Xu, Xu, Xu, Xu, Xu, Xu, Xu, Xu, Xu, Xu, Xu, Xu
Xu, Xu, Xu, Xu, Xu, Xu, Xu, Xu, Xu, Xu, Xu, Xu, Ur, Uu, Xu, Xu, Xu, Xu, Xu, Xu, Xu, Xu, Xu, Xu, Xu, Xu, Xu, Xu, Xu, Xu, Xu, Xu
Xu, Xu, Xu, Xu, Xu, Xu, Xu, Xu, Xu, Xu, Xu, Xu, Uu, Uu, Uu, Xu, Xu, Xu, Xu, Xu, Xu, Xu, Xu, Xu, Xu, Xu, Xu, Xu, Xu, Xu, Xu, Xu
Xu, Xu, Xu, Xu, Xu, Xu, Xu, Xu, Xu, Xu, Xu, Xu, Xu, Uu, Ur, Uu, Xu, Xu, Xu, Xu, Xu, Xu, Xu, Xu, Xu, Xu, Xu, Xu, Uu, Xu, Co, Xu
Xu, Xu, Xu, Xu, Xu, Xu, Xu, Xu, Xu, Xu, Xu, Xu, Xu, Xu, Ur, Uh, Xu, Xu, Xu, Xu, Xu, Xu, Xu, Xu, Xu, Xu, Xu, Xu, Uu, Co, 4 Ko, Co
Xu, Xu, Xu, Xu, Xu, Xu, Uh, Xu, Xu, Xu, Xu, Xu, Xu, Xu, Uu, Uh, Xu, Xu, Xu, Xu, Xu, Xu, Xu, Xu, Xu, Xu, Xu, Xu, Uu, Co, Co, Co
Xu, Xu, Xu, Xu, Xu, Xu, Uh, Xu, Xu, Xu, Xu, Xu, Uu, Ur, Uu, Uu^Tf, Xu, Xu, Xu, Xu, Uh, Uh, Xu, Xu, Xu, Xu, Xu, Xu, Ur, Co, Co, Co
Co, 3 Ko, Co, Xu, Co, Xu, Uh, Uh, Uu^Tf, Xu, Uh, Uh, Uu, Ur, Xu, Xu, Xu, Xu, Xu, Xu, Uh, Uh, Xu, Xu, Xu, Xu, Uu^Vo, Uu, Ur, Uu, Ur, Uu
Co, Co, Co, Co, Ur, Uh, Uu, Uu^Tf, Uu^Ecf, Uu^Vo, Ur, Uu, Xu, Ur, Uh, Xu, Gg, Xu, Xu, Gll^Fp, Uu, Uu^Tf, Uu^Vo, Xu, Uu, Uu^Ecf, Ur, Ur, Xu, Uu, Ur, Uu
Co, Co, Ur, Ur, Uu, Uu, Xu, Xu, Xu, Ur, Xu, Xu, Xu, Uh, Uh, Gg^Es, Hh, Hh, Hh, Gll^Fp, Gg, Uu, Ur, Ur, Xu, Uu, Xu, Xu, Xu, Ur, Uu^Vo, Uu
Uu, Uu^Vo, Ur, Uu, Xu, Xu, Xu, Xu, Xu, Ur, Uu, Xu, Xu, Xu, Xu, Gg, Mm, Ww, Ww, Mm, Gg^Fet, Ur, Xu, Xu, Xu, Xu, Xu, Xu, Uu, Ur, Uu, Uu
Uu, Uu, Ur, Uu, Uu^Vo, Uu^Tf, Xu, Xu, Xu, Xu, Uu, Xu, Uh^Vo, Xu, Xu, Gll^Fp, Mm, Mm, Ww, Mm, Gll^Fp, Xu, Uh, Xu, Xu, Xu, Xu, Xu, Uu, Ur, Xu, Xu
Xu, Xu, Xu, Ur, Ur, Ur, Xu, Xu, Gg, Uu, Xu, Uu, Uh, Uh, Gll^Fp, Gll^Fp, Mm, Mm, Ww, Ww, Gll^Fp, Uh, Uh^Vo, Xu, Xu, Xu, Uh, Uu, Ur, Xu, Xu, Xu
Xu, Xu, Xu, Uu, Uu, Uu, Ur, Uh, Gg^Es, Xu, Xu, Xu, Uh, Uh, Gll^Fp, Mm, Hh, Ww, Mm, Ww, Xu, Uh, Uh, Uu, Xu, Uh, Ur, Ur, Xu, Xu, Xu, Xu
Xu, Xu, Uu, Uu, Xu, Uu, Uh, Uh, Gll^Fp, Xu, Xu, Xu, Xu, Xu, Gg, Gg^Es, Gg, Mm, Gll^Fp, Xu, Xu, Uh, Xu, Uu, Uu, Uu, Uu, Xu, Xu, Xu, Xu, Xu
Xu, Xu, Uu, Xu, Xu, Xu, Uh, Gg, Gll^Fp, Hh, Xu, Xu, Uh, Uu, Xu, Uh, Uh, Gg, Uu, Xu, Xu, Xu, Uu, Ur, Uu, Uu^Vo, Uh, Xu, Xu, Xu, Xu, Xu
Mm, Xu, Hh, Xu, Hh, Uu, Uh, Gll^Fp, Mm, Mm, Mm, Xu, Uh, Uu, Xu, Uh, Uu^Vo, Uh, Uh, Xu, Xu, Xu, Uh, Ur, Uu, Uu, Uh, Uh, Uh, Xu, Xu, Xu
Mm, Mm, Mm, Hh, Xu, Xu, Xu, Xu, Mm, Mm, Hh, Gll^Fp, Gg, Xu, Xu, Uu, Xu, Uu^Ecf, Uh, Xu, Gg, Uh, Uu, Xu, Xu, Xu, Xu, Xu, Xu, Xu, Xu, Xu
Mm, Mm, Hh, Uu, Uh, Xu, Uu, Xu, Gg, Gll^Fp, Gll^Fp, Hh, Xu, Xu, Xu, Xu, Ur, Uu, Xu, Gg, Mm, Gg, Xu, Xu, Xu, Xu, Xu, Xu, Xu, Xu, Xu, Xu
Mm, Hh, Xu, Xu, Uh, Xu, Xu, Uu, Uh, Gg, Gg, Mm, Xu, Xu, Uh, Ur, Uh, Xu, Mm, Mm, Hh^Fp, Hh^Fp, Xu, Xu, Uh, Uh, Uu, Uh, Uh, Xu, Xu, Xu
Xu, Xu, Xu, Xu, Xu, Uu, Uh, Xu, Ur, Uh^Vo, Uh, Xu, Uu, Xu, Uh, Uu, Uh, Uu, Gll^Fp, Gg^Es, Gg, Hh^Fp, Hh, Xu, Uu, Uu, Uh, Uu, Xu, Xu, Xu, Xu
Xu, Xu, Xu, Xu, Xu, Uu, Uh, Xu, Ur, Uu, Xu, Uu, Xu, Uu, Xu, Uu, Xu, Uh, Xu, Ur, Uh, Gg, Hh, Hh, Xu, Uu, Xu, Uh, Xu, Xu, Xu, Xu
Xu, Xu, Xu, Xu, Xu, Xu, Uh, Uh, Ur, Xu, Xu, Xu, Xu, Xu, Xu, Xu, Xu, Xu, Uh, Ur, Uh^Vo, Xu, Xu, Hh, Hh, Xu, Xu, Xu, Xu, Xu, Xu, Xu
Xu, Xu, Xu, Xu, Xu, Xu, Xu, Uu, Uu, Xu, Xu, Xu, Uh, Xu, Ur, Uu^Vo, Uu, Uu, Ur, Ur, Xu, Xu, Xu, Xu, Xu, Xu, Xu, Xu, Xu, Xu, Xu, Xu
Xu, Xu, Xu, Xu, Xu, Xu, Uu^Tf, Uu^Vo, Uu, Xu, Uh, Uh, Ur, Ur, Uu, Uu, Xu, Uu, Uh, Uu, Xu, Xu, Xu, Xu, Xu, Xu, Xu, Xu, Xu, Xu, Xu, Xu
Xu, Xu, Xu, Xu, Xu, Xu, Uu, Uu, Cte, Uh, Uh, Ur, Xu, Xu, Xu, Xu, Xu, Xu, Uh, Uh, Xu, Xu, Xu, Xu, Xu, Xu, Xu, Xu, Xu, Xu, Xu, Xu
Xu, Xu, Xu, Xu, Xu, Xu, Uu, Cte, 1 Kte, Cte, Cte, Uu, Xu, Xu, Xu, Xu, Xu, Xu, Uh, Xu, Xu, Xu, Xu, Xu, Xu, Xu, Xu, Xu, Xu, Xu, Xu, Xu
Xu, Xu, Xu, Xu, Xu, Xu, Uh, Cte, Cte, 2 Kte, Cte, Uu, Xu, Xu, Xu, Xu, Xu, Xu, Xu, Xu, Xu, Xu, Xu, Xu, Xu, Xu, Xu, Xu, Xu, Xu, Xu, Xu
Xu, Xu, Xu, Xu, Xu, Xu, Uu, Ur, Uu, Cte, Uu, Uu, Xu, Xu, Xu, Xu, Xu, Xu, Xu, Xu, Xu, Xu, Xu, Xu, Xu, Xu, Xu, Xu, Xu, Xu, Xu, Xu
Xu, Xu, Xu, Xu, Xu, Xu, Uu, Ur, Xu, Uu, Xu, Xu, Xu, Xu, Xu, Xu, Xu, Xu, Xu, Xu, Xu, Xu, Xu, Xu, Xu, Xu, Xu, Xu, Xu, Xu, Xu, Xu
Xu, Xu, Xu, Xu, Xu, Uu, Ur, Ur, Xu, Xu, Xu, Xu, Xu, Xu, Xu, Xu, Xu, Xu, Xu, Xu, Xu, Xu, Xu, Xu, Xu, Xu, Xu, Xu, Xu, Xu, Xu, Xu
Xu, Xu, Xu, Xu, Xu, Uu, Uu, Uu, Xu, Xu, Xu, Xu, Xu, Xu, Xu, Xu, Xu, Xu, Xu, Xu, Xu, Xu, Xu, Xu, Xu, Xu, Xu, Xu, Xu, Xu, Xu, Xu
