Xu, Ur, Ur, Xu, Xu, Xu, Xu, Xu, Xu, Xu, Xu, Xu, Xu, Xu, Xu, Xu, Xu, Xu, Xu, Xu, Xu, Xu, Xu, Xu, Xu, Xu, Xu, Xu, Uu, Uu, Xu, Xu
Xu, Uu, Xu, Ur, Ur, Xu, Xu, Xu, Xu, Xu, Xu, Xu, Xu, Xu, Xu, Xu, Xu, Xu, Xu, Xu, Xu, Xu, Xu, Xu, Xu, Xu, Xu, Uu, Uu, Xu, Xu, Xu
Xu, Uu, Xu, Xu, Cte, Uu, Uu, Xu, Xu, Xu, Xu, Xu, Xu, Xu, Xu, Xu, Xu, Xu, Xu, Xu, Xu, Xu, Xu, Xu, Xu, Xu, Xu, Uu, Uu, Xu, Xu, Xu
Xu, Uu, Uu, Cte, Cte, 2 Kte, Uu, Xu, Uu, Xu, Xu, Xu, Xu, Xu, Xu, Xu, Xu, Xu, Ur, 3 Ko, Co, Xu, Tb^Tf, Xu, Uh, Xu, Uu, Uu, Xu, Xu, Xu, Xu
Xu, Xu, Uu, 1 Kte, Cte, Cte, Ur, Uu, Xu, Xu, Xu, Xu, Xu, Xu, Xu, Xu, Ur, Ur, Uu, Co, Uu, Uu, Ur^Vd, Uu, Ur, Uu, Uh, Uu, Xu, Xu, Xu, Xu
Xu, Xu, Xu, Uu, Uu, Uu, Ur, Uu, Uu, Xu, Uh, Xu, Ur, Uu, Ur, Uu, Ur, Uu^Vd, Ur, Ur, Ur, Ur, Uu, Ur, Ur, Ur, Ur, Uh, Xu, Xu, Xu, Xu
Xu, Xu, Xu, Xu, Xu, Uu, Uu, Ur, Ur, Uh^Edt, Ur, Ur, Ur, Ur^Vd, Uu, Ur, Xu, Ur, Xu, Xu, Xu, Xu, Xu, Xu, Xu, Ur, Ur, Uu^Vd, Xu, Xu, Xu, Xu
Xu, Xu, Xu, Xu, Xu, Xu, Xu, Xu, Xu, Ur, Xu, Uu^Edt, Xu, Uh, Xu, Xu, Xu, Xu, Xu, Xu, Ss, Ss, Ss, Xu, Xu, Xu, Uh, Uu^Edt, Uu, Xu, Xu, Xu
Xu, Xu, Xu, Xu, Xu, Xu, Xu, Xu, Xu, Xu, Xu, Xu, Xu, Ss, Ss, Ss, Ss, Ss, Ss, Ss, Xu, Xu, Ss, Xu, Xu, Xu, Xu, Ur, Uh, Xu, Xu, Xu
Xu, Xu, Xu, Xu, Xu, Xu, Xu, Xu, Xu, Xu, Ss, Xu, Ss, Xu, Xu, Xu, Xu, Xu, Xu, Xu, Ss, Ss, Xu, Xu, Xu, Xu, Xu, Ur, Uh, Xu, Xu, Xu
Xu, Xu, Xu, Xu, Xu, Xu, Xu, Xu, Ss, Ss, Xu, Ss, Xu, Ss, Ss, Ss, Ss, Ss, Ss, Ss, Xu, Xu, Xu, Xu, Uu, Xu, Ur^Edt, Ur, Uu^Vd, Uh, Xu, Xu
Xu, Xu, Xu, Xu, Uu, Xu, Xu, Xu, Ss, Xu, 4 Ko, Xu, Tb^Tf, Xu, Xu, Xu, Xu, Xu, Xu, Xu, Xu, Xu, Qxu, Uu^Vd, Ur, Ur^Edt, Ur, Ur, Uu, Uh, Xu, Xu
Xu, Xu, Uu, Uu, Xu, Uu, Uh, Uu^Vd, Tb^Tf, Co, Co, Co, Ur^Edt, Uu, Ur, Uh, Uh, Uh, Uu, Uu, Uu, Uh, Uu, Qxu^Bs/, Qxu, Uu, Xu, Tb^Tf, Xu, Xu, Xu, Xu
Xu, Xu, Uu, Xu, Xu, Xu, Uh, Ur^Edt, Ur, Ur, Ur, Co, Ur, Ur, Ur^Vd, Uh, Ur^Edt, Ur^Edt, Ur^Edt, Ur^Edt, Uh, Uh, Uh, Qxu, Qxu, Xu, Xu, Xu, Xu, Xu, Xu, Xu
Xu, Xu, Uu, Xu, Xu, Xu, Ur^Edt, Ur^Edt, Uh, Uh, Uh, Uu, Uu, Ur, Uu, Uu^Edt, Tb^Tf, Uu, Uu, Uu^Vd, Xu, Xu, Xu, Xu, Xu, Xu, Xu, Xu, Xu, Xu, Xu, Xu
Xu, Xu, Uu, Xu, Xu, Ur, Uu, Uh, Xu, Xu, Ss, Xu, Xu, Uh, Xu, Xu, Xu, Xu, Xu, Xu, Xu, Xu, Xu, Xu, Xu, Xu, Uu, Xu, Xu, Xu, Xu, Xu
Xu, Xu, Xu, Uu, Uu, Ur^Vd, Uh, Xu, Xu, Xu, Ss, Xu, Ss, Xu, Ss, Xu, Ss, Xu, Ss, Ss, Ss, Xu, Xu, Xu, Uh, Uh, Co, Co, Co, Xu, Xu, Xu
Xu, Xu, Xu, Xu, Tb^Tf, Ur, Uh, Uh, Xu, Xu, Xu, Ss, Xu, Ss, Xu, Ss, Xu, Ss, Xu, Xu, Xu, Ss, Xu, Uh, Ur^Vd, Ur^Edt, Co, 6 Ko, Co, Uh, Xu, Xu
Xu, Xu, Xu, Xu, Xu, Uu, Ur, Uh, Xu, Xu, Xu, Xu, Ss, Xu, Ss, Xu, Ss, Xu, Ss, Xu, Ss, Ss, Xu, Uh, Ur, Ur^Edt, Ur^Edt, Co, Ur, Uu, Xu, Xu
Xu, Xu, Xu, Xu, Xu, Uh, Uu, Ur^Vd, Qxu, Xu, Xu, Ss, Xu, Ss, Xu, Ss, Xu, Ss, Xu, Ss, Xu, Xu, Xu, Xu, Uu, Ur^Edt, Uu^Edt, Ur, Ur^Vd, Uh, Xu, Xu
Xu, Xu, Xu, Xu, Xu, Qxu, Qxu, Qxu^Bs\, Ur, Xu, Uu, Ss, Uh, Xu, Tb^Tf, Xu, Ur^Edt, Xu^Edt, Ur, Xu, Ur, Ur^Vd, Uu^Edt, Xu, Uh, Ur^Vd, Uu, Uh, Uh, Uh, Xu, Xu
Xu, Xu, Xu, Xu, Xu, Qxu, Xu, Tb^Tf, Uu, Ur^Edt, Ur^Edt, Ur^Edt, Uu^Vd, Uh, Ur, Ur^Edt, Uu^Edt, Ur^Edt, Tb^Tf, Ur, Uu, Uu^Edt, Xu, Uh^Edt, Xu, Uu, Xu, Xu, Xu, Xu, Xu, Xu
Xu, Xu, Xu, Xu, Xu, Xu, Xu, Xu, Co, Co, Co, Uu^Edt, Uu, Uu, Xu, Uu, Xu, Xu, Xu, Xu, Tb^Tf, Xu, Xu, Xu, Xu, Xu, Xu, Xu, Xu, Xu, Xu, Xu
Xu, Xu, Xu, Xu, Xu, Xu, Xu, Xu, Xu, 5 Ko, Ur, Ur, Uu, Uh, Uh, Xu, Tb^Tf, Xu, Uh, Uh, Xu, Xu, Xu, Xu, Xu, Xu, Xu, Xu, Xu, Xu, Xu, Xu
Xu, Xu, Xu, Xu, Xu, Xu, Xu, Xu, Ur, Ur, Xu, Uu, Xu, Xu, Xu, Tb^Tf, Xu, Uu, Xu, Xu, Xu, Xu, Xu, Xu, Xu, Xu, Xu, Xu, Xu, Xu, Xu, Xu
Xu, Xu, Xu, Xu, Xu, Xu, Uu, Uu, Uu, Ur, Xu, Xu, Xu, Xu, Xu, Xu, Xu, Xu, Xu, Xu, Xu, Xu, Xu, Xu, Xu, Xu, Xu, Xu, Xu, Xu, Xu, Xu
Xu, Xu, Xu, Xu, Uu, Xu, Ur, Ur, Xu, Xu, Xu, Xu, Xu, Xu, Xu, Xu, Xu, Xu, Xu, Xu, Xu, Xu, Xu, Xu, Xu, Xu, Xu, Xu, Xu, Xu, Xu, Xu
Xu, Xu, Xu, Uu, Ur, Ur, Xu, Xu, Xu, Xu, Xu, Xu, Xu, Xu, Xu, Xu, Xu, Xu, Xu, Xu, Xu, Xu, Xu, Xu, Xu, Xu, Xu, Xu, Xu, Xu, Xu, Xu
