Mm, Mm, Mm, Mm, Mm, Mm, Mm, Mm, Mm, Mm, Mm, Mm, Mm, Xu, Xu, Uu, Ur, Uu, Xu, Xu, Xu, Xu, Xu, Xu, Xu, Xu, Xu
Mm, Mm, Mm, Mm, Mm, Mm, Mm, Mm, Mm, Mm, Mm, Mm, Mm, Xu, Xu, Uu, Uu, Ur, Ur, Xu, Xu, Xu, Xu, Xu, Xu, Xu, Xu
Mm, Mm, Mm, Mm, Mm, Mm, Mm, Mm, Mm, Mm, Mm, Mm, Mm, Mm, Mm, Xu, Xu, Ur, Ur, Uu, Xu, Xu, Co, Co, Co, Co, Co
Mm, Mm, Mm, Mm, Mm, Mm, Mm, Mm, Mm, Mm, Mm, Mm, Mm, Mm, Mm, Mm, Xu, Uu, Re, Re, Mm, Co, Co^Es, Co, 3 Ko, Co, Co
Mm, Mm, Mm, Mm, Mm, Mm, Mm, Mm, Mm, Mm, Mm, Mm, Mm, Mm, Mm, Mm, Mm, Mm, Re, Mm, Mm, Co, Co^Ecf, Co^Es, Co^Es, Co, Co
Mm, Mm, Mm, Mm, Mm, Mm, Mm, Mm, Mm, Mm, Mm, Mm, Mm, Mm, Mm, Hh, Hh, Mm, Re, Mm, Mm, Co, Co, Co^Es, Co^Es, Co^Ecf, Co
Mm, Mm, Mm, Mm, Mm, Mm, Mm, Mm, Mm, Mm, Mm, Mm, Mm, Mm, Hh^Vo, Hh, Gd, Gd, Gd^Vo, Mm, Mm, Co^Es, Co, Co^Ecf, Co, Co^Es, Co
Mm, Mm, Mm, Mm, Mm, Mm, Mm, Mm, Mm, Mm, Mm, Mm, Mm, Hh, Hh, Hh, Gd, Gd, Hh, Hh^Fp, Mm, Mm, Mm, Co, Xu, Xu, Xu
Mm, Mm, Mm, Mm, Mm, Mm, Mm, Mm, Mm, Mm, Mm, Mm, Mm, Mm, Mm, Hh, Gd, Hh, Hh^Vo, Hh^Fp, Mm, Mm, Mm, Mm, Xu, Xu, Xu
Mm, Mm, Mm, Mm, Mm, Mm, Mm, Mm, Mm, Mm, Mm, Mm, Mm, Mm, Hh, Mm, Re, Hh, Hh, Hh, Hh, Mm, Mm, Mm, Mm, Xu, Xu
Mm, Mm, Mm, Mm, Mm, Mm, Mm, Mm, Mm, Mm, Hh^Fp, Mm, Hh^Fmw, Mm, Hh, Re, Hh, Hh^Fp, Hh, Mm, Mm, Mm, Mm, Mm, Mm, Xu, Xu
Mm, Mm, Mm, Mm, Mm, Mm, Mm, Mm, Mm, Mm, Mm, Hh^Fp, Hh^Fp, Hh^Fms, Hh, Gd, Hh, Hh, Mm, Mm, Mm, Mm, Mm, Mm, Mm, Mm, Xu
Mm, Mm, Mm, Mm, Mm, Mm, Mm, Mm, Mm, Mm, Hh, Mm, Hh, Re, Hh^Fp, Hh^Fp, Hh, Mm, Mm, Mm, Mm, Mm, Mm, Mm, Mm, Mm, Xu
Mm, Mm, Mm, Mm, Mm, Mm, Mm, Mm, Mm, Mm, Mm, Mm, Mm, Re, Hh, Hh, Hh, Mm, Mm, Mm, Mm, Mm, Mm, Mm, Mm, Mm, Mm
Mm, Mm, Mm, Mm, Mm, Mm, Mm, Mm, Mm, Mm, Mm, Mm, Mm, Re, Hh, Hh^Fp, Mm, Mm, Hh, Mm, Mm, Mm, Mm, Mm, Mm, Mm, Mm
Mm, Mm, Mm, Mm, Mm, Mm, Mm, Mm, Wwr, Mm, Wwr, Mm, Mm, Gd, Mm, Mm, Mm, Mm, Hh, Mm, Mm, Mm, Mm, Mm, Mm, Mm, Mm
Mm, Mm, Mm, Mm, Ww, Wwr, Wo, Wwr, Ww, Ww, Ww, Ww, Ww, Gd, Mm, Mm, Mm, Mm, Hh, Mm, Hh, Mm, Mm, Mm, Mm, Mm, Mm
Wwr, Wwr, Wo, Wo, Ww, Wo, Ww, Ww, Gs^Fp, Gs^Fp, Ss, Re, Rb, Ww, Ww, Mm, Mm, Mm, Mm, Hh, Mm, Mm, Mm, Mm, Mm, Mm, Mm
Ww, Ww, Gs^Fp, Ww, Gs^Fp, Gs^Fp, Gs^Fms, Gs^Fmw, Hh^Fp, Ss, Re, Re, Hh, Rb, Ww, Mm, Mm, Mm, Mm, Hh, Mm, Mm, Mm, Mm, Mm, Mm, Mm
Gs^Fp, Gs^Fp, Hh^Fmw, Gs^Fms, Hh, Hh^Fmw, Hh, Hh, Hh, Hh, Hh, Hh, Ss, Ss, Ss, Ww, Ww, Xu, Xu, Mm, Mm, Mm, Mm, Mm, Mm, Mm, Mm
Hh, Hh, Hh^Fp, Hh, Mm, Hh, Mm, Mm, Mm, Mm, Re^Es, Hh, Ss, Hh, Xu, Ss, Ww^Es, Uu^Tf, Uu^Ii, Xu, Mm, Mm, Mm, Mm, Mm, Mm, Mm
Mm, Mm, Mm, Mm, Mm, Mm, Mm, Mm, Mm, Mm, Re^Es, Mm, Mm, Mm, Xu, Uu^Tf, Uu^Tf, Uu^Tf, Uu^Ii, Xu, Mm, Mm, Mm, Mm, Mm, Mm, Mm
Mm, Mm, Mm, Mm, Mm, Mm, Mm, Mm, Hh^Fp, Hh, Re, Hh^Fp, Hh^Fmw, Mm, Xu, Uu, Uh, Ur, Ur, Xu, Xu, Mm, Mm, Mm, Mm, Mm, Mm
Mm, Mm, Mm, Mm, Mm, Mm, Mm, Mm, Hh, Gd, Re, Hh^Fp, Mm, Mm, Mm, Xu, Xu, Uu^Vu, Ur, Uh, Xu, Mm, Mm, Mm, Mm, Mm, Mm
Mm, Mm, Mm, Mm, Mm, Mm, Mm, Mm, Hh, Gd, Mm, Gd, Mm, Mm, Mm, Mm, Xu, Uh, Uu, Uh, Xu, Mm, Mm, Mm, Mm, Mm, Mm
Mm, Mm, Mm, Mm, Mm, Mm, Mm, Hh, Mm, Re, Mm, Hh, Mm, Mm, Mm, Mm, Xu, Uh, Uu, Uu^Tfi, Xu, Mm, Mm, Mm, Mm, Mm, Mm
Mm, Mm, Mm, Mm, Mm, Mm, Hh^Vo, Mm, Hh, Re, Mm, Mm, Mm, Mm, Mm, Mm, Mm, Ur, Uu, Uu, Mm, Mm, Mm, Mm, Mm, Mm, Mm
Mm, Mm, Mm, Mm, Mm, Hh, Gd, Gd, Re, Re, Hh^Vo, Mm, Mm, Mm, Mm, Mm, Hh, Mm, Mm, Mm^Vo, Mm, Mm, Mm, Mm, Mm, Mm, Mm
Mm, Mm, Mm, Mm, Re, Cte, Cte, Re, Mm, Mm, Hh, Hh, Mm, Mm, Hh, Mm, Hh, Mm, Hh, Mm, Mm, Mm, Mm, Mm, Mm, Mm, Mm
Mm, Mm, Mm, Mm, Re, 1 Kte, 2 Kte, Cte, Mm, Mm, Mm, Mm, Hh, Hh, Hh, Hh, Mm, Hh, Mm, Mm, Mm, Mm, Mm, Mm, Mm, Mm, Mm
Mm, Mm, Mm, Mm, Re, Re, Mm, Hh, Mm, Hh, Mm, Mm, Hh^Fp, Hh, Hh^Fp, Mm, Hh^Fms, Mm, Mm, Mm, Mm, Mm, Mm, Mm, Mm, Mm, Mm
Hh, Mm, Re, Re, Re, Mm, Mm, Mm, Hh, Mm, Hh, Hh, Hh, Hh, Hh^Fp, Hh^Fp, Hh, Hh^Fp, Hh^Fp, Mm, Mm, Mm, Mm, Mm, Mm, Mm, Mm
