Uu, Uu, Xu, Uu, Xu, Xu, Xu, Xu, Xu, Xu, Xu, Xu, Xu, Xu, Xu, Xu, Xu, Xu, Xu, Xu, Xu, Xu, Xu, Xu, Xu, Xu, Xu, Xu, Xu, Xu, Xu, Uu, Uu, Uu, Ur
Ur, Uu, Uu, Xu, Uh, Xu, Xu, Xu, Xu, Xu, Xu, Xu, Xu, Xu, Xu, Xu, Xu, Xu, Xu, Xu, Xu, Xu, Xu, Xu, Xu, Xu, Uh, Uu, Uu, Uh, Uu, Uu, Ur, Ur, Uu
Uu, Ur, Uu, Uu, Uh, Uu, Uu^Vu, Xu, Xu, Xu, Xu, Xu, Xu, Xu, Xu, Xu, Xu, Xu, Uh, Xu, Uh, Xu, Uh, Xu, Uu, Uh, Uh, Uu, Cte, Cte, Cte, Ur, Uu, Uu, Xu
Xu, Ur, Ur, Uu^Vu, Ur, Ur, Ur, Uu, Co^Vo, Co^Es, Co, Xu, Uh, Xu, Xu, Xu, Xu, Xu, Uh, Uh, Uu^Vu, Uu, Uh, Uu, Uu, Uh, Uu, Uu, Cte, 1 Kte, 2 Kte, Cte, Uu, Xu, Xu
Xu, Xu, Uu, Ur, Uu, Uu, Ur, Co^Es, Co, Co, Ur, Co, Uu, Uh, Uu, Uu, Uu, Xu, Uh, Uu, Uu, Ur, Uu^Tfi, Uu^Tf, Uu, Uh, Ur, Uu, Ur, Cte, Cte, Cte, Uh, Xu, Xu
Xu, Xu, Xu, Uh, Xu, Uu, Uu^Vu, Ur, Co, Co^Es, Uu, Ur, Ur, Uu^Vu, Ur, Ur, Ur, Uu, Ur, Ur, Ur, Ur, Ur, Uu, Ur, Ur, Uu, Ur, Uu^Ii, Uu, Uu, Uh, Uh, Xu, Xu
Xu, Xu, Xu, Xu, Xu, Xu, Xu, Xu, Xu, Xu, Xu, Xu, Xu, Ur, Uh, Uh, Uu, Uu, Uu^Tf, Uu, Uu^Tfi, Uu^Tf, Uu, Ur, Uu^Vu, Uu, Uu, Uu^Ii, Uu, Uh, Uh, Uh, Xu, Xu, Xu
Xu, Xu, Xu, Xu, Xu, Xu, Xu, Xu, Xu, Xu, Xu, Xu, Xu, Xu, Xu, Xu, Xu, Xu, Xu, Xu, Xu, Uu^Tfi, Uu^Tf, Ur, Uu, Uh, Uh, Uh, Xu, Uu, Xu, Uh, Xu, Xu, Xu
Xu, Xu, Xu, Xu, Xu, Xu, Uu^Tf, Xu, Ss, Xu, Uu^Tf, Xu, Uu, Xu, Xu, Xu, Xu, Xu, Xu, Xu, Uu, Uu, Ur, Ur, Uu^Vu, Uu, Uu, Xu, Xu, Xu, Xu, Xu, Xu, Xu, Xu
Xu, Xu, Xu, Xu, Xu, Uh, Ss, Uh, Uu^Vu, Ss, Ur, Uu, Ur, Uu, Uu, Uu, Uu, Uu, Uu, Uu, Ur, Ur, Ur, Uu, Ur, Uu, Uu, Uu, Uu^Vu, Uh, Xu, Xu, Xu, Xu, Xu
Uu, Xu, Xu, Xu, Xu, Uh, Uu^Tf, Uu, Ur^Ii, Ur, Ss, Ur, Xu, Ur, Ur, Uu^Vu, Uu, Uu, Ur, Ur, Uu, Xu, Co, Ur, Uh, Ur, Ur, Uu, Uu, Uh, Uu, Xu, Xu, Xu, Xu
Uu, Uu, Uu^Vu, Xu, Co, Co, Uu, Ur^Ii, Uu^Tfi, Uu^Tf, Xu, Xu, Xu, Xu, Uu, Ur, Uh, Uu^Vu, Uu, Uu^Vu, Xu, Xu, Co, Ur, Uu, Uh, Uu, Ur, Uu, Uu, Uu, Uu, Xu, Xu, Xu
Xu, Uu, Uu, Uu, Uu, Uu, Uu^Vu, Ur, Xu, Xu, Xu, Xu, Xu, Xu, Xu, Uu, Uh, Uu^Tf, Xu, Uh, Xu, Xu, Uu, Ur, Co, Uu, Uu, Ur, Ur, Uu^Vu, Uu, Uh, Xu, Xu, Xu
Xu, Xu, Xu, Uu, Xu, Xu, Xu, Uu, Xu, Xu, Uu, Uu, Uu, Xu, Xu, Xu, Xu, Xu, Xu, Xu, Xu, Xu, Uu, Uu, Xu, Co, Xu, Uu, Uu, Ur, Ur, Uh, Uu, Xu, Xu
Xu, Xu, Xu, Xu, Xu, Xu, Uu, Ur, Uu, Uu, Ur, Uu^Vu, Ur, Uu, Uu, Xu, Uu, Xu, Uh, Uu, Uu, Uu, Ur, Ur, Xu, Xu, Xu, Uh, Xu, Co, Co, Co^Vo, Co, Xu, Xu
Xu, Xu, Xu, Xu, Uh, Uu, Uu, Ur, Ur, Ur, Uu, Ur, Uu, Ur, Ur, Uu, Ur, Uu, Uh, Uu^Vu, Ur^Ii, Ur, Uu, Xu, Wo, Wo, Wo, Xu, Xu, Uu, Ur, Co^Es, Co, Xu, Xu
Xu, Xu, Xu, Uh, Uu, Uu^Vu, Ur, Ur, Uu, Uu, Uh, Uh, Xu, Uu, Xu, Ur, Uu, Ur^Ii, Ur, Uu^Ii, Ur, Uu^Tf, Xu, Xu, Ww, Uu^Vu, Wo, Xu, Xu, Uu^Vu, Ur, Co, Uh, Xu, Xu
Xu, Xu, Uh, Uh, Uu, Ur, Uu, Uu, Co^Es, Co, Co, Xu, Xu, Xu, Xu, Xu, Xu, Uh, Uu, Uu, Ur^Ii, Uh, Ww, Wwr, Ww, Ww, Xu, Xu, Uh, Uh, Uu, Ur, Uh, Uu, Xu
Xu, Xu, Uu, Uh, Uu, Ur, Uu, Uu, Co^Es, Co^Vo, Xu, Xu, Xu, Xu, Xu, Xu, Xu, Uh, Uh, Uu^Vu, Ur, Uh, Wwr, Wwr, Ww, Uu^Tf, Uu^Tf, Uu, Uh, Uu^Vu, Uu, Ur, Uh, Uu, Xu
Xu, Xu, Uu, Uu, Uu^Vu, Ur, Uu, Co, Co^Es, Co^Es, Xu, Xu, Xu, Xu, Xu, Xu, Xu, Xu, Uh, Uu, Ur, Uh, Uu, Uu, Uu^Vu, Uu, Ur, Ss, Uu, Uu, Ur, Ur, Uu^Vu, Xu, Xu
Xu, Xu, Xu, Uu, Uu, Ur, Uu, Xu, Xu, Xu, Xu, Xu, Xu, Xu, Xu, Xu, Xu, Xu, Uu, Uu^Tf, Ur, Ss, Ur, Ur, Ur, Ur, Ss, Ur, Ur, Ur, Uu^Tf, Uu, Xu, Xu, Xu
Xu, Xu, Xu, Uu, Uu, Ur, Uu, Xu, Xu, Xu, Xu, Xu, Uu^Vu, Xu, Xu, Xu, Co, Co, Ur, Ur, Ur, Ur, Uu, Uu, Uu, Uu^Tf, Uh, Ss, Uu, Ur, Ur, Xu, Xu, Xu, Xu
Xu, Xu, Xu, Xu, Xu, Ur, Ur, Uu, Uu, Xu, Xu, Uu, Uu, Uu, Uu, Xu, Co, Ur, Uu^Vu, Uu, Uu^Tf, Uu^Tf, Uh, Ss, Uu^Tf, Uu, Uh, Uu, Xu, Ur, Uu, Co, Co, Xu, Xu
Xu, Xu, Xu, Xu, Xu, Uu, Uh, Ur, Uu, Uu, Uu, Xu, Xu, Ur, Ur, Co^Vo, Ur, Uu, Uu, Uu, Ss, Ss, Uh, Uu, Uu^Vu, Uh, Co, Co, Xu, Uu, Uu, Uu, Uu, Xu, Xu
Xu, Xu, Xu, Xu, Xu, Xu, Uh, Uu, Uu, Uu^Vu, Uu, Uu^Tf, Uu, Uu, Ur, Ur, Uu, Uu, Uh, Uh, Xu, Uh, Xu, Ss, Uh, Ss, Xu, Xu, Xu, Xu, Uu^Tf, Ur, Uu^Vu, Xu, Xu
Xu, Xu, Xu, Xu, Xu, Xu, Xu, Uu, Uu, Ur, Ur, Uu^Ii, Ur^Ii, Ur, Co, Co, Uu, Xu, Xu, Xu, Xu, Xu, Xu, Xu, Xu, Xu, Xu, Xu, Xu, Uu^Tf, Ur, Ur, Uu, Xu, Xu
Xu, Xu, Xu, Xu, Xu, Xu, Xu, Uh, Uh, Uh, Uu^Tf, Ur, Uu, Uu^Ii, Uu^Tf, Uu, Ur, Ur, Ur, Uu^Vu, Uu, Xu, Xu, Xu, Xu, Xu, Xu, Xu, Xu, Ur, Uh, Uu, Xu, Uu, Xu
Xu, Xu, Uh, Uh, Uh, Xu, Xu, Xu, Xu, Uh, Uu^Tf, Ur^Ii, Ur, Ur, Ur, Ur, Co, Uh, Uh, Ur, Ur, Ur, Ur, Uu^Tf, Uu^Tf, Xu, Xu, Xu, Uu, Ur, Uu^Vu, Uh, Xu, Xu, Xu
Xu, Xu, Uh, Uu, Uu, Uh, Xu, Xu, Xu, Xu, Uu, Uu^Ii, Ur, Uu^Vu, Ur, Co, Uh, Uh, Uh, Uu, Uu, Uu^Vu, Uh, Ur, Uu, Xu, Xu, Xu, Ur, Ur, Xu, Xu, Xu, Xu, Xu
Xu, Xu, Uu, Uu, Uu, Uh, Uu^Tf, Xu, Xu, Xu, Xu, Uu, Uh, Ur, Uh, Uh, Xu, Xu, Xu, Uh, Xu, Uu, Uh, Ur, Ur, Xu, Co^Vo, Co, Ur, Co, Xu, Xu, Xu, Xu, Xu
Xu, Xu, Uh, Uu^Vu, Ur, Uu, Uu, Uh, Uu, Xu, Co, Co, Uh, Uu, Uu, Uu^Tf, Xu, Xu, Xu, Xu, Xu, Xu, Xu, Uu^Tf, Co, Ur, Co, Co^Es, Ur, Co, Xu, Xu, Xu, Xu, Xu
Xu, Xu, Uh, Uu, Uu, Ur, Ur, Uh, Ur, Uu, Uu, Uu, Ur, Uu, Ur, Uu^Tf, Uu, Xu, Xu, Xu, Xu, Xu, Xu, Xu, Xu, Co^Es, Co, Uu, Uu, Uu, Uh, Xu, Xu, Xu, Xu
Xu, Xu, Xu, Uu, Uu, Uu, Uu, Ur, Uu, Ur, Ur, Ur, Uu, Uh, Uu, Ur, Uu^Vu, Uh, Xu, Xu, Xu, Xu, Xu, Xu, Xu, Co, Uu, Ur, Uu^Vu, Uu^Tf, Uh, Xu, Xu, Xu, Xu
Xu, Xu, Xu, Xu, Xu, Xu, Xu, Uu^Vu, Xu, Uu, Uh, Uu^Tf, Uu, Uh, Ur, Ur, Uu, Uh, Xu, Xu, Xu, Xu, Xu, Xu, Xu, Xu, Xu, Ur, Ur, Uu, Uu, Uh, Uh, Uh, Uh
Xu, Xu, Xu, Xu, Xu, Xu, Xu, Xu, Xu, Xu, Xu, Uu, Uu, Ur, Uu, Uu, Xu, Xu, Xu, Xu, Xu, Xu, Xu, Xu, Xu, Xu, Xu, Uu, Uu, Ur, Ur, Uh, Uh, Uh, Uu
