Xu, Xu, Xu, Xu, Xu, Xu, Xu, Xu, Xu, Xu, Xu, Xu, Xu, Xu, Xu, Xu, Xu, Xu, Xu, Xu, Xu, Xu, Xu
Xu, Xu, Xu, Xu, Xu, Xu, Uu^Vu, Xu, Xu, Xu, Cte, 6 Kte, Cte, Xu, Xu, Xu, Uu^Vu, Xu, Xu, Xu, Xu, Xu, Xu
Xu, Xu, Uh, Xu, Uu, Uu, Ur, Uh, Xu, Cte, Cte, Cte, Cte, Cte, Xu, Uu, Uu, Uh, Uu, Xu, Uh, Xu, Xu
Xu, Xu, Uu, Uu, Uh, Uh, Uu, Uu, Xu, Cte, Cte, Cte, Cte, Cte, Xu, Uh, Uh, Uh, Xu, Uu, Uh, Xu, Xu
Xu, Xu, Uu, Xu, Uh, Uu, Ur^Es, Uh, Xu, Cte, Cte, Cte, Cte, Cte, Xu, Uh, Uh, Ur^Es, Xu, Xu, Uu, Xu, Xu
Xu, Uh, Xu, Xu, Uu, Uu, Ur^Es, Uh, Uu, Xu, Xu, Cte, Xu, Xu, Uh, Ur^Es, Uh, Ur^Es, Xu, Xu, Uh, Uu, Uh
Uh, Uu, Xu, Xu, Uh, Uu^Vu, Ur^Es, Ur^Es, Ur^Es, Uh, Ur, Xu, Ur, Uh, Ur^Es, Ur^Es, Uh, Uu^Vu, Uu, Uu, Xu, Uu, Uh
Uh, Uh, Uu, Uu, Uh, Uu, Uh, Uu, Ur^Es, Uh, Uu, Ur, Uu, Uh, Ur^Es, Uu, Uh, Uu, Uh, Uh, Xu, Uu, Uu
Uu, Uu^Tf, Xu, Uu, Uu, Uu, Xu, Xu, Xu, Ur^Es, Uh, Ur, Uu, Ur^Es, Xu, Xu, Xu, Xu, Uu^Tf, Uu^Vu, Xu, Uh, Uu
Xu, Uu^Tf, Xu, Uu, Uu, Xu, Xu, Xu, Xu, Xu, Uu, Ur, Uu, Xu, Xu, Xu, Xu, Xu, Uu, Uh, Uh, Uh, Xu
Xu, Uh, Uu, Uu^Tf, Uu, Uu^Vu, Xu, Xu, Xu, Xu, Uh, Ur, Uh, Xu, Xu, Xu, Xu, Xu, Uu^Vu, Uh, Uh, Xu, Xu
Xu, Xu, Uu^Vu, Uu, Uu, Uh, Xu, Uu^Vu, Xu, Xu, Uh, Ur, Uh, Xu, Xu, Uu^Vu, Uh, Xu, Uu, Uu, Uu, Uh, Xu
Xu, Xu, Uu, Uh, Uu, Uh, Uu, Uh, Uu, Xu, Uu, Ur, Uu, Xu, Uh, Uu, Uh, Uh, Uu, Uh, Uu, Uh, Xu
Xu, Uh, Uh, Uh, Uu, Uu, Xu, Uh, Uu, Uu, Cte, Cte, Cte, Uu, Uu, Uu, Xu, Uh, Xu, Xu, Uh, Uh, Xu
Qxua, Xu, Xu, Xu, Uh, Uu, Xu, Uu, Uh, Cte, Cte, 3 Kte, Cte, Cte, Uu, Xu, Xu, Uh, Uu^Vu, Xu, Xu, Xu, Qxua
Qxua, Qxua, Xu, Xu, Uh, Uu^Vu, Xu, Xu, Uh, Uh, Xu, Cte, Xu, Uh, Uu, Uh, Xu, Uu^Tf, Uh, Xu, Xu, Qxua, Qxua
Qxua, Qxua, Xu, Uu^Vu, Uu, Uu^Tf, Uu, Uu, Uh, Xu, Uh, Xu, Uh, Xu, Xu, Uh, Uu, Uu^Tf, Uh, Uu^Vu, Xu, Qxua, Qxua
Qxua, Qxua, Xu, Uh, Uh, Uh, Xu, Uu^Vu, Xu, Xu, Uu, Ur, Uu, Xu, Xu, Uu^Vu, Xu, Uu, Uu, Uu^Tf, Xu, Qxua, Qxua
Qxua, Qxua, Xu, Uu^Vu, Uh, Uu^Vu, Xu, Xu, Uu, Uh, Ur, Ur, Ur, Uh, Uh, Xu, Xu, Uu^Vu, Uh, Uu^Vu, Xu, Qxua, Qxua
Qxua, Qxua, Cte, Xu, Xu, Xu, Uh, Xu, Uu, Uh, Uu, Ur, Uu, Uu, Uh, Xu, Uu, Xu, Xu, Xu, Cte, Qxua, Qxua
Cte, Cte, Cte, Cte, Cte, Xu, Uh, Uu, Uh, Uu, Cte, Ur, Cte, Uu, Uh, Uu, Uh, Xu, Cte, Cte, Cte, Cte, Cte
Cte, 4 Kte, Cte, Cte, Cte, Xu, Uu, Uu, Uh, Cte, 1 Kte, Cte, 2 Kte, Cte, Uu, Uu, Uh, Xu, Cte, Cte, Cte, 5 Kte, Cte
Cte, Cte, Cte, Cte, Cte, Xu, Uh, Uu, Uu, Cte, Cte, Cte, Cte, Cte, Uh, Uu, Uh, Xu, Cte, Cte, Cte, Cte, Cte
