Cud, Cud, Cud, Xu, Xu, Xu, Xu, Xu, Xu, Xu, Xu, Xu, Xu, Xu, Xu, Xu, Xu, Xu, Xu, Xu, Xu, Xu
Cud, 3 Kud, Cud, Cud, Cud, Xu, Xu, Xu, Xu, Xu, Xu, Xu, Xu, Xu, Ur, Xu, Xu, Xu, Xu, Xu, Xu, Xu
Cud, Cud, Ur, Cud, Cud, Cud, Xu, Xu, Ur, Xu, Xu, Xu, Ur, Ur, Xu, Ur, Ur, Xu, Xu, Xu, Xu, Xu
Cud, Cud, Cud, Ur, Ur, Ur, Ur, Ur, Xu, Ur, Ur, Ur, Xu, Xu, Ur, Ur, Xu, Ur, Xu, Xu, Xu, Xu
Xu, Cud, Cud, Cud, Ur, Ur, Ur, Cud, Hh, Xu, Xu, Xu, Uu^Vud, Uu^Vud, Ur, Uu^Vud, Xu, Ur, Xu, Xu, Xu, Xu
Xu, Xu, Xu, Xu, Ur, Ur, Cud, Cud, Rp, Hh, Hh, Xu, Xu, Ur, Uu^Vud, Xu, Uh, Ur, Uh, Uu^Vud, Xu, Xu
Xu, Xu, Uu^Vud, Ur, Xu, Xu, Xu, Hh, Hh, Rp, Mm, Mm, Mm, Xu, Xu, Xu, Uu^Vud, Ur, Uu, Uu^Vud, Xu, Xu
Xu, Xu, Xu, Ur, Uu, Uu^Vud, Xu, Mm, Mm, Rp, Rp, Mm, Hh^Vhh, Mm, Gs^Fp, Xu, Xu, Ur, Ur, Xu, Xu, Xu
Xu, Xu, Uu^Vud, Ur, Uh, Uu^Vud, Xu, Mm, Mm, Hh, Mm, Rp, Rp, Gs^Fp, Hh^Vhh, Mm, Rp, Xu, Uh, Ur, Xu, Xu
Xu, Xu, Xu, Ur, Xu, Xu, Mm, Mm, Hh^Vhh, Mm, Mm, Gs^Fp, Rp, Gs^Fp, Hh, Mm, Rp, Xu, Xu, Ur, Xu, Xu
Xu, Xu, Xu, Ur, Xu, Xu, Mm, Mm, Mm, Mm, Hh, Gs^Fp, Rp, Hh, Mm, Mm, Mm, Rp, Rp, Cud, Xu, Xu
Xu, Uu^Vud, Uh, Ur, Uu^Vud, Xu, Gs^Fp, Mm, Mm, Mm, Gs^Fmw, Gs^Fp, Rp, Hh, Hh^Vhh, Mm, Hh^Vhh, Hh, Hh, Rp, Hh^Vhh, Xu
Xu, Xu, Uh, Ur, Uu, Xu, Mm, Gs^Fp, Gs^Fp, Gs^Fmw, Hh^Vhh, Gs^Fp, Rp, Hh, Hh, Mm, Mm, Mm, Hh, Rp, Gs^Fp, Gs^Fp
Xu, Uu^Vud, Xu, Ur, Cud, Xu, Mm, Mm, Gs^Fmw, Gs^Fp, Mm, Mm, Mm, Rp, Rp, Gs^Fp, Mm, Mm, Hh, Rp, Gs^Fp, Gs^Fp
Gs^Fp, Xu, Mm, Xu, Mm, Rp, Rp, Hh^Vhh, Gs^Fp, Gs^Fp, Mm, Mm, Gs^Fmw, Gs^Fp, Rp, Gs^Fp, Mm, Hh^Vhh, Rp, Rp, Gs^Fp, Gs^Fmw
Gs^Fp, Gs^Fp, Mm, Mm, Mm, Mm, Hh, Rp, Rp, Mm, Mm, Hh^Vhh, Mm, Gs^Fp, Rp, Gs^Fp, Rp, Rp, Hh, Mm, Hh^Vhh, Gs^Fmw
Gs^Fp, Gs^Fp, Gs^Fp, Hh^Vhh, Gs^Fmw, Gs^Fmw, Hh, Mm, Rp, Mm, Mm, Mm, Mm, Gs^Fp, Rp, Rp, Hh, Hh, Hh, Mm, Mm, Gs^Fp
Gs^Fp, Gg^Fet, Gs^Fp, Gs^Fp, Hh^Vhh, Hh, Hh, Mm, Mm, Rp, Rp, Mm, Rp, Rp, Hh, Rp, Hh, Mm, Hh, Mm, Mm, Mm
Gs^Fp, Gs^Fp, Mm, Gs^Fp, Hh, Hh, Mm, Hh, Mm, Mm, Mm, Rp, Mm, Cte, Cte, Cte, Cte, Cte, Mm, Hh^Vhh, Mm, Mm
Mm, Mm, Hh^Vhh, Mm, Hh, Mm, Mm, Hh^Vhh, Mm, Mm, Hh^Vhh, Mm, Hh, Cte, 1 Kte, Cte, 2 Kte, Cte, Mm, Mm, Mm, Mm
Mm, Mm, Mm, Mm, Mm, Mm, Mm, Mm, Mm, Mm, Mm, Mm, Mm, Hh, Hh, Rp, Rp, Mm, Mm, Mm, Mm, Mm
Mm, Mm, Mm, Mm, Mm, Mm, Mm, Mm, Mm, Mm, Mm, Mm, Mm, Mm, Hh, Hh, Rp, Hh, Mm, Mm, Mm, Mm
