Wo, Mm, Mm, Mm, Mm, Mm, Mm, Mm, Mm, Mm, Mm, Mm, Mm, Mm, Mm, Mm, Mm, Mm, Mm, Mm, Hh^Fp, Hh^Fp
Mm, Wo, Wo, Mm, Mm, Mm, Mm, Mm, Mm^Vo, Mm, Mm, Mm, Mm, Mm, Hh^Fp, Mm, Mm, Mm, Mm, Mm, Hh^Fp, Hh^Fp
Mm, Mm, Mm, Wo, Wo, Mm, Mm, Mm, Mm, Mm, Mm, Mm, Mm, Mm, Hh^Fp, Mm, Cte, Cte, 3 Kte, Hh^Fp, Hh^Fp, Hh^Fp
Mm, Mm, Mm, Mm, Mm, Wo, Mm, Mm, Mm, Mm, Mm^Vo, Hh^Fp, Hh^Fp, Hh^Fp, Mm, Mm, Mm, Cte, Cte, Cte, Mm, Hh^Fp
Mm, Mm, Mm, Mm, Mm, Wo, Wo, Mm, Mm, Mm, Mm, Mm, Hh^Fp, Hh^Fp, Hh^Fp, Hh^Fp, Mm, Mm, Mm, Mm, Mm, Mm
Mm, Mm, Mm, Mm, Mm, Mm, Mm, Wo, Wo, Mm, Mm, Hh^Fp, Mm, Mm, Hh^Fp, Mm, Mm, Mm, Mm, Mm, Mm, Mm
Mm, Mm, Mm, Mm^Vo, Mm, Mm, Mm, Mm, Wo, Mm, Mm, Mm, Mm, Mm, Mm, Mm, Hh, Hh^Vo, Mm, Mm, Mm, Mm
Hh, Mm, Mm, Mm, Mm, Mm, Mm, Mm, Mm, Wo, Wo, Mm, Mm, Mm, Mm, Hh, Hh, Hh, Hh, Mm, Mm, Mm
Hh, Hh, Mm, Mm, Mm, Mm, Mm, Mm^Vo, Mm, Mm, Mm, Wo, Mm, Mm, Mm, Mm, Hh^Vo, Hh, Hh, Hh^Vo, Mm, Mm
Hh, Mm, 1 Kte, Mm, Cte, Mm, Hh, Mm, Hh^Vo, Mm, Mm, Ww, Ww, Mm, Mm, Mm, Hh, Hh, Mm, Mm, Mm, Mm
Hh, Hh, Hh, Cte, Hh, Mm, Hh, Hh, Hh, Mm, Mm, Mm, Mm, Ww, Wo, Hh, Hh, Mm, Mm, Mm, Mm, Mm
Mm, Hh, 2 Kte, Cte, Cte, Hh, Mm, Mm, Mm, Hh, Hh, Hh, Mm, Hh^Vo, Wo, Wo, Mm, Mm, Mm, Mm, Mm, Mm
Mm, Mm, Mm, Mm, Mm, Mm, Mm, Mm, Mm, Mm, Mm, Mm, Mm, Hh, Wo, Mm, Mm, Mm, Mm, Mm^Vo, Mm, Mm
Mm, Mm, Mm, Mm, Mm, Mm, Mm, Mm^Vo, Mm, Mm, Mm, Mm, Mm, Mm, Mm, Wo, Wo, Mm, Mm, Mm, Mm, Mm
Wo, Mm, Mm, Mm, Mm, Mm, Mm, Mm, Hh^Fp, Mm, Hh, Hh^Fp, Mm, Mm, Mm, Mm, Mm, Wo, Mm, Mm, Mm, Mm
Mm, Wo, Wo, Mm, Mm, Mm, Wo, Mm, Mm, Hh, Mm, Mm, Mm, Mm, Mm, Mm^Vo, Mm, Wo, Wo, Mm, Mm, Mm
Mm, Mm, Mm, Wo, Wo, Wo, Mm, Wo, Wo, Hh^Fp, Ww, Mm, Ww, Mm, Mm, Mm, Mm, Mm, Mm, Wo, Wo, Mm
Mm, Mm, Mm, Mm, Mm, Wo, Mm, Mm, Mm, Wo, Hh, Ww, Mm, Wo, Wo, Mm, Wo, Mm, Wo, Mm, Wo, Wo
Mm, Mm, Mm^Vo, Mm, Mm, Mm, Mm, Mm, Hh^Vo, Hh, Mm, Mm, Mm, Mm, Mm, Wo, Cte, Wo, Mm, Wo, Wo, Wo
Mm, Hh^Fp, Hh^Fp, Mm, Mm, Mm, Hh^Vo, Hh, Hh, Mm, Hh^Fp, Mm, Hh^Fp, Hh^Vo, Hh, Cte, 4 Kte, Cte, Hh, Mm, Mm, Wo
Mm, Mm, Mm, Mm, Mm, Mm, Mm, Hh, Hh, Hh^Fp, Hh, Hh, Hh^Fp, Hh, Hh, Cte, Cte, Cte, Mm, Mm, Mm, Mm
Mm, Mm, Mm, Mm, Mm, Mm, Mm, Hh, Hh, Hh^Fp, Hh^Fp, Hh^Fp, Hh^Fp, Hh^Fp, Hh, Hh, Mm, Mm, Mm, Mm, Mm, Mm
