Xu, Xu, Xu, Xu, Xu, Xu, Xu, Xu, Xu, Xu, Xu, Xu, Xu, Xu, Xu, Xu, Xu, Uu, Uu, Uu, Ur, Ur
Xu, Xu, Uu^Vu, Xu, Uu^Vu, Xu, Xu, Xu, Xu, Xu, Xu, Xu, Xu, Xu, Xu, Xu, Cte, Uu, 1 Kte, Ur, Uu, Uu
Xu, Xu, Uu, Uu^Tf, Uu, Uu, Uu, Uh, Uu, Xu, Xu, Xu, Xu, Xu, Xu, Uu, Cte, Cte, Qxu, 2 Kte, Uu, Xu
Xu, Xu, Uu^Vu, Uu, Uu^Vu, Qxu, Qxu, Qxu, Qxu, Uu, Uh, Xu, Xu, Xu, Xu, Uu, Ur, Cte, Cte, Cte, Cte, Xu
Xu, Xu, Qxu, Qxu, Qxu, Qxu, Uh, Qxu, Qxu, Qxu, Qxu, Uh, Uu, Xu, Uu^Vu, Uu, Ur, Uu, Uu, Cte, Uu, Xu
Xu, Xu, Qxu, Qxu, Uh, Uu, Uu, Uh, Uu, Uh, Uu, Qxu, Uu, Uu, Ur, Ur, Uu, Uu^Vu, Uh, Uu, Xu, Xu
Xu, Xu, Qxu, Uh, Uu, Uu, Uu, Uu^Vu, Uu^Tf, Uu, Uu, Uu, Ur, Ur, Uu, Uu, Uu, Uu, Xu, Xu, Xu, Xu
Xu, Xu, Uu^Vu, Uu, Xu, Xu, Uu^Tf, Uu, Uh, Uh, Qxu, Uh, Ur, Uu, Uu^Tf, Uu, Uh, Uu, Uu^Vu, Xu, Xu, Xu
Xu, Xu, Uu, Uu, Xu, Xu, Xu, Uu, Uh^Vu, Qxu, Qxu, Uh, Ur, Uu^Vu, Xu, Xu, Xu, Uh, Uu, Uu^Tf, Xu, Xu
Xu, Xu, Uh, Uh, Xu, Xu, Uh, Uu, Uu, Qxu, Qxu, Uh^Vu, Ur, Uh, Uh, Xu, Xu, Xu, Uu, Uu^Vu, Xu, Xu
Xu, Xu, Uu, Uu, Uu^Vu, Xu, Uh, Qxu, Qxu, Qxu^Bs\, Ur, Ur, Uh, Qxu, Qxu, Uh, Xu, Xu, Uh, Uu, Xu, Xu
Xu, Xu, Xu, Uu, Uu^Tf, Uh, Qxu, Qxu, Qxu, Uh, Ur, Uh, Qxu, Qxu, Qxu, Uh, Uh, Xu, Uu, Uh, Xu, Xu
Xu, Xu, Uu^Tf, Uu^Vu, Uu, Uh, Qxu, Qxu, Qxu, Uh, Ur, Uh, Qxu, Qxu, Qxu, Qxu, Uh, Uu^Vu, Uu, Uu, Xu, Xu
Xu, Xu, Uh, Uu, Uu^Tf, Uh, Uh, Qxu, Qxu^Bs/, Ur, Qxu, Ur, Qxu^Bs\, Qxu, Uh^Vu, Uu, Uh, Uh, Uh, Uu^Tf, Xu, Xu
Qxu, Qxu, Uu, Uh, Xu, Xu, Uu^Vu, Ur, Qxu, Qxu, Qxu, Qxu, Ur, Ur, Xu, Xu, Xu, Uu, Uu, Xu, Xu, Xu
Qxu, Qxu, Qxu, Uu, Uu^Tf, Xu, Xu, Ur, Qxu, Qxu, Qxu, Ur, Uh, Xu, Xu, Xu, Xu, Uu, Uh^Vu, Qxu, Qxu, Xu
Qxu, Qxu, Qxu, Uu, Uu, Uh, Uu, Ur, Qxu, Qxu, Qxu, Ur, Uu^Vu, Xu, Xu, Xu, Uu^Tf, Uu, Uh, Qxu, Qxu, Qxu
Xu, Qxu, Qxu, Qxu, Qxu, Qxu, Uu, Ur, Ur, Qxu, Ur, Ur, Uu, Xu, Uh, Uu, Uu, Uu, Uh, Qxu, Qxu, Qxu
Xu, Xu, Qxu, Qxu, Qxu, Cer, Cer, Cer, Cer, Ur, Xu, Uh, Xu, Uu, Uh, Uu^Tf, Qxu, Uh^Vu, Qxu, Qxu, Qxu, Qxu
Xu, Xu, Xu, Qxu, Qxu, Cer, Cer, 3 Ker, Cer, Cer, Xu, Xu, Xu, Uh, Uh^Vu, Uh, Qxu, Qxu, Qxu, Qxu, Qxu, Qxu
Xu, Xu, Xu, Xu, Xu, Uu, Ur, Cer, Uu, Cte, Qxu, Qxu, Qxu, Qxu, Qxu, Qxu, Qxu, Qxu, Qxu, Qxu, Qxu, Qxu
Xu, Xu, Xu, Xu, Uu, Uu, Ur, Uu, Qxu, Qxu, Qxu, Qxu, Qxu, Qxu, Qxu, Qxu, Qxu, Qxu, Qxu, Qxu, Qxu, Qxu
