Xu, Xu, Xu, Xu, Xu, Xu, Xu, Xu, Xu, Xu, Xu, Xu, Xu, Xu, Xu, Xu, Xu, Uu, Uu, Uu, Ur, Ur
Xu, Xu, Xu, Xu, Xu, Xu, Xu, Xu, Xu, Xu, Xu, Xu, Xu, Xu, Xu, Xu, Uu, Uu, 1 Kte, Ur, Uu, Uu
Xu, Xu, Xu, Xu, Xu, Xu, Xu, Xu, Xu, Xu, Xu, Xu, Xu, Xu, Xu, Uu, Uu, Cte, Cte, 2 Kte, Uu, Xu
Xu, Xu, Xu, Xu, Xu, Uu, Uu, Uu^Vu, Xu, Xu, Xu, Xu, Xu, Xu, Xu, Uu, Ur, Cte, Cte, Cte, Uu, Xu
Xu, Xu, Xu, Xu, Xu, Xu, Uu, Xu, Xu, Xu, Xu, Xu, Xu, Xu, Uu^Vu, Uu, Ur, Uu, Uu, Uu, Xu, Xu
Xu, Xu, Xu, Xu, Uh, Uh, Uu, Uh, Uu, Uh, Uu, Xu, Uh, Uh, Ur, Ur, Uu, Uu^Vu, Xu, Xu, Xu, Xu
Xu, Xu, Xu, Uh, Uu, Uu, Uh, Uu^Vu, Uu, Uu, Uu, Uh, Uu, Ur, Uu, Uu, Xu, Xu, Xu, Xu, Xu, Xu
Xu, Xu, Uu^Vu, Uh, Xu, Xu, Uh, Uu, Uh, Uh, Ql, Uu, Uh, Ur, Uu, Uh, Uh, Xu, Uu^Vu, Xu, Xu, Xu
Xu, Xu, Uu, Uu, Xu, Xu, Xu, Uu, Uu^Vu, Ql, Ql, Uu, Uu, Ur, Xu, Xu, Xu, Uu, Uu, Uu, Xu, Xu
Xu, Xu, Uh, Xu, Xu, Xu, Uu, Uu, Uh, Ql, Ql, Uu^Vu, Ur, Ur, Xu, Xu, Xu, Xu, Uu, Uu^Vu, Xu, Xu
Xu, Xu, Xu, Uu, Uu^Vu, Xu, Uu, Ql, Ql, Uh, Ur, Ur, Uh, Ql, Ql, Xu, Xu, Xu, Uh, Uu, Xu, Xu
Xu, Xu, Xu, Uu, Uh, Uh, Ql, Ql, Ql, Uh, Ur, Uh, Ql, Ql, Ql, Xu, Uh, Xu, Uu, Uh, Xu, Xu
Xu, Xu, Xu, Uu^Vu, Uh, Uh, Ql, Ql, Ql, Uh, Ur, Uu^Vu, Ql, Ql, Ql, Ql, Uh, Uu^Vu, Uu, Uh, Xu, Xu
Xu, Xu, Xu, Uu, Uh, Uu, Uu, Ql, Ur, Ur, Ql, Ur, Ur, Ql, Uh, Uh, Uu, Uh, Uu, Uh, Xu, Xu
Xu, Xu, Xu, Xu, Xu, Xu, Uu^Vu, Ur, Ql, Ql, Ql, Ql, Ur, Uu^Vu, Xu, Xu, Xu, Uu, Uu, Xu, Xu, Xu
Xu, Xu, Xu, Xu, Xu, Xu, Xu, Ur, Ql, Ql, Ql, Ur, Uu, Xu, Xu, Xu, Xu, Uu, Uu^Vu, Xu, Xu, Xu
Xu, Xu, Xu, Xu, Xu, Xu, Xu, Ur, Ql, Ql, Ql, Ur, Uu^Vu, Xu, Xu, Xu, Xu, Uu, Uh, Xu, Xu, Xu
Xu, Xu, Xu, Xu, Xu, Xu, Uu, Ur, Ur, Ql, Ur, Ur, Uh, Xu, Xu, Xu, Uh, Uu, Uh, Xu, Xu, Xu
Xu, Xu, Xu, Xu, Xu, Uu, Cud, Cud, Cud, Ur, Xu, Uh, Xu, Uu, Uh, Uh, Xu, Uu^Vu, Xu, Xu, Xu, Xu
Xu, Xu, Xu, Xu, Xu, Uu, Cud, 3 Kud, Cud, Uu, Xu, Xu, Xu, Uu, Uu^Vu, Xu, Xu, Xu, Xu, Xu, Xu, Xu
Xu, Xu, Xu, Xu, Xu, Uu, Ur, Cud, Uu, Uu, Xu, Xu, Xu, Xu, Xu, Xu, Xu, Xu, Xu, Xu, Xu, Xu
Xu, Xu, Xu, Xu, Ur, Ur, Uu, Uu, Xu, Xu, Xu, Xu, Xu, Xu, Xu, Xu, Xu, Xu, Xu, Xu, Xu, Xu
