Aa^Fpa, Aa^Fpa, Aa^Fpa, Aa^Fpa, Xu, Xu, Xu, Xu, Xu, Xu, Xu, Xu, Uu, Uu, Uh, Uu, Uh, Uu, Ur, Uu, Uu, Uu
Aa^Fpa, Aa^Fpa, Hhd^Vo, Aa^Fpa, Xu, Xu, Xu, Xu, Xu, Xu, Xu, Uu^Vu, Uu, Uh, Uu, Uh, Ur, Ur, Uu, Uh, Uu^Vu, Uu
Aa^Fpa, Aa^Fpa, Hhd, Hhd, Ms, Ms, Ms, Xu, Xu, Xu, Uu, Uu, Cud, Cud, Cud, Cud, Cud, Ur, Uu^Vu, Uh, Uh, Uh
Aa^Fpa, Hhd, Hhd^Vo, Hhd, Hhd, Hhd^Vo, Ms, Xu, Xu, Uu^Vu, Uu, Uu, Cud, Cud, 3 Kud, Cud, Cud, Ur, Uu, Uh, Xu, Xu
Hhd, Hhd, Ms, Ms, Ms, Hhd, Ms, Xu, Xu, Uu, Uu^Vu, Uu, Cud, Cud, Cud, Cud, Cud, Uu, Uu, Uu^Vu, Xu, Xu
Hhd, Hhd, Hhd^Vo, Ms, Ms, Ms, Ms, Xu, Xu, Xu, Uu, Uu, Uu, Cud, Uu, Cud, Uu, Uu, Xu, Xu, Xu, Xu
Ms, Ms, Ms, Ms, Ms, Ms, Ms, Xu, Ms, Xu, Ms, Ms, Ms, Ms, Hhd^Vo, Ms, Ms, Ms, Ms, Xu, Xu, Xu
Ms, Ms, Aa, Aa, Aa, Aa, Ms, Ms, Ms^Voa, Ms, Ms, Ms, Ms, Ms, Hhd, Ms, Ms, Ms, Ms, Ms, Ms, Xu
Ms, Ms, Aa, Aa, Ms, Ms, Ms, Ms, Ms, Ms, Ms, Ms, Ms, Ms, Hhd, Ms, Ms, Ms, Ms, Hhd, Ms, Ms
Aa, Aa, Aa, Qxu, Qxu, Ms, Ms, Ms^Voa, Ms, Ms, Ms, Ms^Voa, Hhd, Hhd, Hhd, Ms, Ms, Ms, Ms, Ms^Voa, Ms, Ms
Ms, Aa, Ms, Aa, Qxu, Qxu, Qxu, Ms, Qxu, Ms, Ms, Ms, Aa, Hhd, Hhd, Ms^Voa, Ms, Ms, Ms, Hhd, Hhd, Ms
Ms, Ms, Hhd, Ms, Ms, Qxu, Qxu, Qxu, Qxu, Ms, Aa, Aa, Ms, Ms, Ms, Ms, Ms, Ms, Ms, Hhd, Hhd, Ms
Ms, Ms, Hhd, Hhd, Mm^Voa, Ms, Qxu, Qxu, Qxu, Qxu, Aa, Aa, Aa, Ms, Qxu, Ms, Ms, Ms, Ms, Ms^Voa, Hhd, Ms
Hhd, Hhd, Hhd^Vo, Ms, Ms, Ms, Qxu, Qxu, Qxu, Qxu, Qxu, Aa, Aa, Aa, Qxu, Qxu, Qxu, Ms, Ms, Ms, Ms, Ms
Hhd, Ms, Ms, Ms, Ms, Ms, Ms, Ms, Hhd, Qxu, Aa, Qxu, Aa, Aa, Qxu, Qxu, Qxu, Qxu, Qxu, Ms, Hh, Ms
Ms, Ms, Ms, Ms, Ms, Ms, Ms, Hhd^Vo, Hhd, Hhd, Aa, Aa, Aa, Qxu, Qxu, Qxu, Qxu, Qxu, Qxu, Qxu, Ms, Ms
Ms, Ms, Hhd^Vo, Ms, Ms, Ms, Ms, Hhd, Hhd^Vo, Hhd, Aa, Aa, Hhd, Ms, Ms, Hhd, Hhd, Qxu, Ms, Qxu, Ms, Ms
Ms, Ms, Hhd, Hhd, Cte, Cte, Cte, Hhd, Hhd, Hhd, Hhd, Hhd, Ms, Ms, Ms, Ms, Hhd, Hhd^Vo, Hhd, Ms, Ms, Ms
Ms, Ms, Hhd, 1 Kte, Cte, Cte, Cte, Hhd, Ms, Ms, Ms, Hhd^Vo, Ms, Ms, Ms, Ms, Hhd^Vo, Hhd, Ms, Hhd^Vo, Ms, Ms
Hhd, Hhd, Hhd, Hhd, 2 Kte, Cte, Hhd, Hhd, Ms, Ms, Ms, Ms, Ms, Hhd, Hhd^Vo, Ms, Ms, Ms, Ms, Ms, Ms, Ms
Hhd, Hhd, Hhd, Hhd, Ms, Hhd, Ms, Ms, Ms, Ms, Ms, Ms, Ms, Hhd, Ms, Ms, Ms, Ms, Ms, Ms, Ms, Ms
Hhd, Hhd, Ms, Ms, Ms, Ms, Ms, Ms, Ms, Ms, Ms, Ms, Ms, Ms, Ms, Ms, Ms, Ms, Ms, Ms, Ms, Ms
