Xu, Xu, Xu, Xu, Xu, Xu, Xu, Xu, Xu, Xu, Xu, Xu, Xu, Xu, Xu, Xu, Xu, Uu, Uu, Uu, Ur, Ur
Xu, Xu, Uu^Vu, Xu, Uu^Vu, Xu, Xu, Xu, Xu, Xu, Xu, Xu, Xu, Xu, Xu, Xu, Uu, Uu, 1 Kte, Ur, Uu, Uu
Xu, Xu, Uh, Uh, Uu, Uu, Uu^Tf, Uh, Uu, Xu, Xu, Xu, Xu, Xu, Xu, Uu, Uu, Cte, Cte, 2 Kte, Uu, Xu
Xu, Xu, Uu^Vu, Uu, Uu^Vu, Xu^Vu, Xu, Xu, Xu, Uu^Tf, Uh, Xu, Xu, Xu, Xu, Uu, Ur, Cte, Cte, Cte, Uu, Xu
Xu, Xu, Xu, Xu, Xu, Xu, Uu, Xu, Xu, Xu, Xu, Uh, Uu^Tf, Xu, Uu^Vu, Uu, Ur, Uu, Uu, Uu, Xu, Xu
Xu, Xu, Xu, Xu, Uh, Uh, Ur, Uh, Uu, Uh, Uu, Xu, Uh, Uh, Ur, Ur, Uu, Uu^Vu, Uh, Xu, Xu, Xu
Xu, Xu, Xu, Uh, Uu, Ur, Uh, Uu^Vu, Uu, Uu, Uu, Uh, Uu, Ur, Uu, Uu, Uu, Uh, Xu, Xu, Xu, Xu
Xu, Xu, Uu^Vu, Uh, Xu, Xu, Uh, Uu, Uh, Uh, Qxu, Uu, Uh, Ur, Uu, Uh, Uh, Uu, Uu^Vu, Xu, Xu, Xu
Xu, Xu, Uu, Ur, Uu^Tf, Xu, Xu, Uu, Uu^Vu, Qxu, Qxu, Uu, Uu^Tf, Ur, Xu, Xu, Xu, Uu, Ur, Uh, Xu, Xu
Xu, Xu, Uh, Ur, Xu, Xu, Uu, Uu, Uh, Qxu, Qxu, Uu^Vu, Ur, Ur, Xu, Xu, Xu, Xu, Ur, Uu^Vu, Xu, Xu
Xu, Xu, Uu, Uu^Tf, Uu^Vu, Xu, Uu, Qxu, Qxu, Qxu^Bs\, Ur, Ur, Uh, Qxu, Qxu, Xu, Xu, Xu, Uh, Uu, Xu, Xu
Xu, Xu, Xu, Ur, Uh, Uh, Qxu, Qxu, Qxu, Uh, Ur^Tf, Uh, Qxu, Qxu, Qxu, Xu, Uh, Xu, Uu^Tf, Uh, Xu, Xu
Xu, Xu, Uu, Uu^Vu, Uh, Uh, Qxu, Qxu, Qxu, Uh, Ur, Uu^Vu, Qxu, Qxu, Qxu, Qxu, Uh, Uu^Vu, Uu, Uh, Xu, Xu
Xu, Xu, Uu^Tf, Ur, Uh, Uu, Uu, Qxu, Qxu^Bs/, Ur, Qxu, Ur, Qxu^Bs\, Qxu, Uh, Uh, Uu^Tf, Uh, Uu^Tf, Uh, Xu, Xu
Qxu, Xu, Uu^Tf, Uu^Tf, Xu, Xu, Uu^Vu, Ur, Qxu, Qxu, Qxu, Qxu, Ur^Tf, Uu^Vu, Xu, Xu, Xu, Uu^Tf, Uu^Tf, Xu, Xu, Xu
Qxu, Qxu, Qxu, Uu, Uu^Tf, Xu, Xu, Ur^Tf, Qxu, Qxu, Qxu, Ur, Uu, Xu, Xu, Xu, Xu, Ur, Uu^Vu, Qxu, Qxu, Xu
Qxu, Qxu, Qxu, Uu^Tf, Ur, Uu^Tf, Uu, Ur, Qxu, Qxu, Qxu, Ur, Uu^Vu, Xu, Xu, Xu, Ur, Uu^Tf, Uh, Qxu, Qxu, Qxu
Xu, Qxu, Qxu, Qxu, Qxu, Qxu, Uu, Ur, Ur, Qxu, Ur, Ur^Tf, Uh, Xu, Ur, Ur, Uh, Uu, Uh, Qxu, Qxu, Qxu
Xu, Xu, Qxu, Qxu, Qxu, Cte, Cte, Cte, Cte, Ur, Xu, Uh, Xu, Uu^Tf, Uh, Uh, Qxu, Uu^Vu, Qxu, Qxu, Qxu, Qxu
Xu, Xu, Xu, Qxu, Qxu, Cte, Cte, 3 Kte, Cte, Cte, Xu, Xu, Xu, Ur, Uu^Vu, Qxu, Qxu, Qxu, Qxu, Qxu, Xu, Xu
Xu, Xu, Xu, Xu, Xu, Uu, Ur, Cte, Uu, Cte, Qxu, Xu, Qxu, Xu, Qxu, Qxu, Qxu, Qxu, Qxu, Xu, Xu, Xu
Xu, Xu, Xu, Xu, Ur, Ur, Uu, Uu, Qxu, Qxu, Qxu, Qxu, Qxu, Qxu, Qxu, Qxu, Qxu, Qxu, Xu, Xu, Xu, Xu
