Xu, Xu, Xu, Xu, Xu, Xu, Xu, Xu, Xu, Xu, Xu, Xu, Mm, Ss, Ss, Ss, Ss, Ss, Ss, Mm, Mm, Xu
Xu, Xu, Xu, Xu, Uu^Ii, Xu, Uu, Uu, Uu, Uu, Uu, Xu, Xu, Mm, Mm, Ss, Ss, Ss, Mm, Mm, Mm, Mm
Xu, Xu, Uu, Uu, Xu, Uu^Ii, Re, Xu, Xu, Xu, Xu, Uu, Uu, Xu, Uu, Ss, Ss, Ss, Mm, Mm, Mm, Mm
Xu, Uu, Xu, Xu, Uh, Re, Xu, Uh, Uh, Xu, Uu^Tf, Uh, Re, Re, Uu, Uu, Xu, Mm, Xu, Mm, Xu, Mm
Xu, Uu^Tf, Xu, Uh, Re, Xu, Xu, Xu, Xu, Uh, Uu^Vu, Uh, Xu, Xu, Xu, Xu, Xu, Xu, Uu, Xu, Xu, Xu
Xu, Re, Uu^Ii, Re, Uu, Uu, Uu, Uh, Uh, Xu, Xu, Xu, Uh, Uh, Uu^Tf, Uu, Uh, Re, Cte, 4 Kte, Uu, Xu
Xu, Re, Uu^Ii, Xu, Re, Xu, Uu^Vu, Uu, Re, Xu, Uu, Xu, Uu^Ii, Xu, Xu, Xu, Xu, Re, Xu, Cte, Uu, Xu
Xu, Uu^Tf, Re, Xu, Re, Uu^Ii, Uu, Uh, Uh, Re, Uu^Ii, Uh, Uu^Tf, Uu^Ii, Uu, Uu^Vu, Uh, Xu, Uu, Re, Xu, Xu
Xu, Uu^Tf, Uu^Ii, Xu, Xu, Uu^Tf, Re, Re, Uu^Vu, Uh, Uu, Uu, Re, Re, Re, Uu, Uu^Ii, Uh, Xu, Re, Xu, Xu
Xu, Uh, Uh, Uu^Vu, Xu, Xu, Xu, Xu, Xu, Xu, Xu, Re, Xu, Xu, Uu, Uu, Xu, Uh, Uu, Uu, Uu, Xu
Xu, Xu, Uu^Vu, Re, Uu, Uh, Uh, Uu^Vu, Uu, Uu^Vu, Uh, Xu, Xu, Uu^Vu, Re, Re, Re, Xu, Uu, Uu^Vu, Re, Xu
Xu, Xu, Uu, Uh, Re, Uh, Uu^Vu, Uu^Tf, Xu, Uu, Xu, Uu^Vu, Xu, Xu, Uu, Uh, Xu, Xu, Uh, Re, Re, Xu
Xu, Xu, Uu, Xu, Re, Xu, Xu, Xu, Uu, Xu, Uh, Xu, Uu^Tf, Uu^Tf, Re, Uh, Xu, Uh, Uh, Xu, Re, Xu
Xu, Xu, Uh, Re, Xu, Xu, Uu, Uu^Vu, Re, Uh, Uh, Uh, Re, Re, Re, Uu^Tf, Xu, Xu, Uu, Uh, Xu, Xu
Xu, Uu^Tf, Uu, Xu, Uu^Tf, Uh, Re, Uh, Uu^Vu, Uu, Xu, Xu, Xu, Uh, Xu, Uu^Vu, Xu, Uh, Uu, Uu^Vu, Xu, Xu
Xu, Xu, Re, Xu, Uh, Uh, Re, Xu, Xu, Xu, Uu^Ii, Uu^Ii, Xu, Xu, Xu, Xu, Xu, Uh, Re, Xu, Xu, Xu
Xu, Xu, Re, Xu, Uh, Uu, Xu, Xu, Uu, Uu, Uu, Re, Re, Uu^Vu, Xu, Uu^Vu, Uu, Xu, Re, Uh, Uu^Ii, Xu
Xu, Uh, Uh, Xu, Uu, Uu, Xu, Xu, Uu, Uh, Uh, Uu^Ii, Uu, Re, Uu, Xu, Uh, Re, Uu^Vu, Xu, Uu^Ii, Uu
Xu, Cte, Cte, Xu, Cte, Cte, Cte, Cte, Cte, Uh, Xu, Xu, Xu, Uu^Vu, Xu, Uu, Uh, Re, Uu^Tf, Xu, Uu, Uu
Xu, 5 Kte, Xu, Xu, Cte, 1 Kte, Cte, 2 Kte, Cte, Xu, Xu, Xu, 3 Kte, Xu, Uu, Xu, Xu, Xu, Xu, Uh, Uu, Uu
Xu, Xu, Xu, Xu, Uh, Cte, Uu, Cte, Uh, Xu, Xu, Cte, Xu, Cte, Xu, Uu, Uu, Re, Re, Uh, Xu, Xu
Xu, Xu, Xu, Xu, Uh, Uu, Uu, Uu, Uu, Xu, Xu, Xu, Xu, Xu, Xu, Xu, Xu, Xu, Xu, Xu, Xu, Xu
