Cer, Cer, Cer, Xu, Xu, Xu, Xu, Xu, Xu, Xu, Xu, Xu, Xu, Qxu, Qxu, Qxu, Qxu, Uu, Re, Cer, Cer, Cer
Cer, 4 Ker, Cer, Re, Uu^Vu, Xu, Xu, Xu, Xu, Xu, Xu, Xu, Xu, Qxu, Qxu, Qxu, Qxu, Uu, Re, Cer, 5 Ker, Cer
Cer, Cer, Cer, Re, Xu, Xu, Xu, Xu, Uu^Vu, Xu, Xu, Xu, Uu^Vu, Xu, Qxu, Qxu, Xu, Uu, Re, Cer, Cer, Cer
Uu, Cer, Uu, Re, Re, Xu, Xu, Xu, Uu, Xu, Re, Uh, Xu, Xu, Qxu, Xu, Uu^Tf, Re, Uu, Cer, Uu, Cer
Uu, Uu, Qxu, Uu^Tf, Uu, Re, Uu^Tf, Xu, Uu, Re, Xu, Uh, Uu^Tf, Xu, Qxu, Xu, Uu, Re, Xu, Uu, Uu, Uu
Qxu, Qxu, Qxu, Uu^Vu, Qxu, Re, Uu, Uu, Xu, Xu, Uu^Vu, Xu, Uu^Tf, Xu, Uu^Tf, Xu, Uh, Re, Xu, Xu, Xu, Xu
Qxu, Qxu, Qxu, Qxu, Uh, Re, Re^Es, Xu, Xu, Uu^Tf, Uu, Xu, Xu, Uu, Uu^Tf, Uu, Re, Re, Xu, Xu, Xu, Xu
Qxu, Qxu, Qxu, Uu^Vu, Uu^Tf, Uu^Tf, Re, Uu^Tf, Xu, Uu^Vu, Uu, Uh, Re, Re, Re, Re^Es, Uu^Tf, Xu, Xu, Uu^Vu, Xu, Xu
Qxu, Qxu, Uu, Uu, Re, Uu, Uu^Vu, Re, Re, Xu, Xu, Uh, Re, Uu^Vu, Re, Xu, Xu, Uh, Uu^Tf, Uu^Tf, Xu, Xu
Qxu, Qxu, Qxu, Uu^Tf, Re, Xu, Xu, Uh, Uh, Re, Re, Re, Uu, Re, Re, Uu^Vu, Xu, Uu, Re, Uu^Vu, Xu, Xu
Qxu, Qxu, Xu, Uh, Uu, Xu, Uu^Vu, Xu, Uu^Tf, Cud, 6 Kud, Cud, Uu, Uh, Uh, Re, Re^Es, Re, Uu, Xu, Xu, Xu
Xu, Xu, Xu, Uh, Xu, Xu, Uu, Uu, Uu^Tf, Cud, Uu^Tf, Cud, Uh, Uh, Uu, Uh, Re, Uh, Uu^Vu, Xu, Xu, Xu
Xu, Xu, Uu^Vu, Uh, Xu, Uu^Vu, Xu, Xu, Uu, Re, Re, Re, Uu, Re, Uu^Vu, Xu, Re, Uh, Qxu, Qxu, Qxu, Xu
Xu, Xu, Xu, Re, Xu, Xu, Uu^Vu, Uh, Uh, Xu, Uu^Tf, Xu, Uu^Tf, Uu^Tf, Xu, Xu, Re, Uu^Tf, Qxu, Qxu, Qxu, Qxu
Xu, Xu, Xu, Re, Re, Xu, Re^Es, Uh, Xu, Xu, Uu, Uu^Vu, Xu, Uh, Uu, Xu, Re, Uh, Xu, Qxu, Qxu, Qxu
Xu, Xu, Xu, Xu, Uh, Xu, Re, Uh, Xu, Uu^Vu, Xu, Xu, Uu^Vu, Uu, Re, Re, Xu, Xu, Xu, Xu, Qxu, Qxu
Xu, Xu, Xu, Xu, Uu^Vu, Uu, Re, Uu, Xu, Xu, Re, Uu^Tf, Uu, Uu, Re, Uu^Tf, Uu^Vu, Xu, Xu, Uu^Vu, Qxu, Qxu
Xu, Xu, Xu, Xu, Uu, Re, Uu, Xu, Re, Re, Uu, Xu, Uh, Xu, Xu, Re, Re, Xu, Xu, Uh, Uh, Qxu
Xu, Xu, Cte, Cte, Uu, Uu, Uu, Uu, Uu^Vu, Xu, Uu, Re, Re, Xu, Xu, Xu, Uu^Tf, Re, Re, Uh, Cer, Uu
Xu, Xu, 1 Kte, Cte, Cte, Cte, Uu, Uh, Xu, Xu, Wo, Uu^Vu, Wo, Re, Uh, Uh, Wo, Ww, Uu, Cer, Cer, Cer
Uh, Uh, Uu, Uu, 2 Kte, Cte, Xu, Uh, Xu, Xu, Wo, Wo, Wo^Es, Wo, Wo, Wo, Wo, Ww, Uu, Cer, 3 Ker, Cer
Uu, Uh, Uu, Uu, Xu, Xu, Xu, Xu, Wo, Wo, Wo, Wo, Wo, Wo, Wo, Wo, Wo, Ww, Uu, Cer, Cer, Cer
