Xu, Xu, Xu, Xu, Xu, Xu, Xu, Xu, Xu, Xu, Xu, Xu, Mm, Mm, Mm, Ss, Ss, Ss, Mm, Mm, Mm, Xu
Xu, Xu, Xu, Xu, Xu, Xu, Xu, Xu, Xu, Xu, Xu, Xu, Xu, Mm, Mm, Ss, Gg, Ss, Mm, Mm, Mm, Mm
Xu, Xu, Xu, Xu, Uu, Uu, Uu, Xu, Xu, Xu, Xu, Xu, Xu, Xu, Xu, Gg, Gg, Gg, Xu, Xu, Xu, Xu
Xu, Xu, Xu, Uu, Xu, Xu, Xu, Cud, 5 Kud, Xu, Xu, Xu, Xu, Xu, Xu, Xu, Xu, Uu^Ii, Uh, Xu, Xu, Xu
Xu, Xu, Xu, Uu, Xu, Xu, Xu, Xu, Xu, Xu, Xu, Xu, Xu, Xu, Xu, Xu, Xu, Uu^Ii, Uh, Xu, Xu, Xu
Xu, Xu, Xu, Uu, Xu, Xu, Uh, Xu, Xu, Xu, Xu, Xu, Uu, Uu^Vu, Uh, Uu, Uu, Uu, Uu, Xu, Xu, Xu
Xu, Xu, Xu, Uu, Uu, Uu^Vu, Xu, Uh, Uu, Uh, Uu^Ii, Uu, Uh, Uh, Uu, Uu, Uh, Xu, Xu, Xu, Xu, Xu
Xu, Xu, Xu, Uu, Uh, Xu, Xu, Xu, Xu, Uu^Ii, Xu, Xu, Xu, Xu, Xu, Xu, Xu, Xu, Xu, Xu, Xu, Xu
Xu, Xu, Xu, Xu, Uh, Xu, Xu, Xu, Xu, Xu, Xu, Xu, Xu, Xu, Xu, Xu, Uu, Xu, Cud, 4 Kud, Xu, Xu
Xu, Xu, Xu, Uu^Vu, Uu, Uu^Ii, Uu^Ii, Uu, Xu, Xu, Uu^Vu, Xu, Xu, Xu, Uu, Uu, Xu, Uu, Xu, Xu, Xu, Xu
Xu, Xu, Uu, Xu, Re, Uu, Uh, Uu^Ii, Uu, Uh, Uh, Uu, Uu^Ii, Uu, Xu, Xu, Xu, Xu, Xu, Xu, Xu, Xu
Xu, Xu, Xu, Uu, Uu, Re, Xu, Uu, Xu, Uu, Xu, Uu, Xu, Uh, Re, Xu, Uh, Xu, Xu, Xu, Xu, Xu
Xu, Xu, Xu, Xu, Uu, Uh, Re, Xu, Uu, Xu, Uh, Xu, Xu, Uu^Vu, Re, Re^Ii, Uh, Xu, Xu, Xu, Xu, Xu
Xu, Xu, Xu, Uh, Xu, Re, Uh, Uh, Xu, Uu, Uu, Uh, Uu, Xu, Xu, Re^Ii, Re^Ii, Uu^Vu, Xu, Xu, Xu, Xu
Xu, Xu, Xu, Xu, Xu, Xu, Xu, Xu, Uh, Xu, Xu, Uu, Uu, Uh, Uu, Xu, Uu, Uu, Xu, Xu, 3 Kud, Xu
Xu, Xu, Xu, Xu, Xu, Xu, Uh, Uu^Vu, Re, Uh, Re, Xu, Uu, Uu, Uh, Xu, Uu^Vu, Re, Xu, Xu, Cud, Xu
Xu, Xu, Xu, Xu, Xu, Uu, Uu, Uu, Xu, Re, Xu, Uu^Ii, Uu^Ii, Uu, Re, Xu, Uu, Re, Uh, Uh, Xu, Xu
Xu, Xu, Xu, Xu, Cte, Uu, Cte, Uu, Cte, Xu, Xu, Xu, Uu^Vu, Uu, Re, Uu, Xu, Uu^Vu, Uh, Xu, Xu, Xu
Xu, Xu, Xu, Xu, Uu, Cte, Cte, Cte, Uu, Xu, Xu, Xu, Uu, Re, Uh, Xu, Xu, Xu, Xu, Xu, Xu, Xu
Xu, Xu, Xu, Xu, Uu, 1 Kte, Cte, 2 Kte, Uu, Uu, Xu, Xu, Xu, Xu, Xu, Xu, Xu, Xu, Xu, Xu, Xu, Xu
Xu, Xu, Xu, Xu, Uu, Uu, Re, Uu, Uu, Uu, Xu, Xu, Xu, Xu, Xu, Xu, Xu, Xu, Xu, Xu, Xu, Xu
Xu, Xu, Xu, Xu, Uu, Uu, Re, Uu, Uu, Uu, Xu, Xu, Xu, Xu, Xu, Xu, Xu, Xu, Xu, Xu, Xu, Xu
