Xu, Xu, Xu, Xu, Xu, Xu, Xu, Xu, Xu, Xu, Xu, Xu, Mm, Ss, Ss, Ss, Ss, Ss, Ss, Mm, Mm, Xu
Xu, Xu, Xu, Xu, Uu^Ii, Xu, Xu, Xu, Xu, Xu, Xu, Xu, Xu, Mm, Mm, Ss, Ss, Ss, Mm, Mm, Mm, Mm
Xu, Xu, Uu, Uu, Xu, Uu^Ii, Uu, Xu, Xu, Xu, Xu, Xu, Uu, Xu, Uu, Ss, Ss, Ss, Mm, Mm, Mm, Mm
Xu, Uu, Xu, Xu, Uh, Uu, Xu, Uh, Uh, Xu, Uu^Tf, Uh, Uu, Uu, Uu, Uu, Xu, Mm, Xu, Mm, Xu, Mm
Xu, Uu, Xu, Uh, Uu, Xu, Xu, Xu, Xu, Uh, Uu^Vu, Uh, Xu, Xu, Xu, Xu, Xu, Xu, Xu, Xu, Xu, Xu
Xu, Uu, Uu^Ii, Uh, Uu, Uu, Xu, Xu, Xu, Xu, Xu, Xu, Uh, Uh, Uu, Uu, Uh, Xu, Uu, 4 Kte, Xu, Xu
Xu, Uu, Uu^Ii, Xu, Uu, Xu, Uu^Vu, Xu, Xu, Xu, Uu, Xu, Uu^Ii, Xu, Xu, Xu, Xu, Uu, Xu, Cte, Xu, Xu
Xu, Uu, Uu, Xu, Uu, Uu^Ii, Uu, Uh, Uh, Xu, Uu^Ii, Uh, Uu, Uu^Ii, Uu, Uu^Vu, Uh, Xu, Uu, Uu, Xu, Xu
Xu, Uu, Uu^Ii, Xu, Xu, Uu, Xu, Uu, Uu^Vu, Uh, Uu, Uu, Uu, Uu, Xu, Uu, Uu^Ii, Uh, Xu, Xu, Xu, Xu
Xu, Uh, Uh, Uu^Vu, Xu, Xu, Xu, Xu, Xu, Xu, Xu, Xu, Xu, Xu, Uu, Uu, Xu, Uh, Uu, Xu, Xu, Xu
Xu, Xu, Uu^Vu, Uu, Uu, Uh, Uh, Uu^Vu, Uu, Uu, Cte, Xu, Xu, Uu^Vu, Xu, Uu, Uu, Xu, Uu, Uu^Vu, Xu, Xu
Xu, Xu, Xu, Uu, Xu, Uh, Xu, Uu, Xu, Uu, Xu, 5 Kte, Xu, Xu, Uu, Uh, Xu, Xu, Uh, Uu, Xu, Xu
Xu, Xu, Xu, Xu, Xu, Xu, Xu, Xu, Uu, Xu, Uh, Xu, Uu, Uu, Uu, Uh, Xu, Uh, Uh, Xu, Xu, Xu
Xu, Xu, Xu, Xu, Xu, Xu, Uu, Uu^Vu, Uu, Uh, Uh, Uh, Uu, Uu, Uu, Uu, Xu, Xu, Uu, Uh, Xu, Xu
Xu, Xu, Xu, Xu, Uu, Uh, Uu, Uh, Uu^Vu, Uu, Xu, Xu, Xu, Uh, Xu, Uu^Vu, Xu, Uh, Uu, Uu^Vu, Xu, Xu
Xu, Xu, Xu, Xu, Uh, Uh, Uu, Xu, Xu, Xu, Uu^Ii, Uu^Ii, Xu, Xu, Xu, Xu, Xu, Uh, Uu, Xu, Xu, Xu
Xu, Xu, Xu, Xu, Uh, Uu, Xu, Xu, Uu, Uu, Uu, Uu, Uu, Uu^Vu, Xu, Xu, Xu, Xu, Uu, Uh, Uu^Ii, Xu
Xu, Xu, Xu, Xu, Uu, Uu, Xu, Xu, Uu, Uh, Uh, Uu^Ii, Uu, Uu, Uu, Xu, Uh, Uh, Uu^Vu, Xu, Uu^Ii, Xu
Xu, Xu, Xu, Xu, Cte, Cte, Cte, Cte, Cte, Uh, Xu, Xu, Xu, Uu^Vu, Xu, Uu, Uh, Uh, Uu, Xu, Uu, Xu
Xu, Xu, Xu, Xu, Cte, 1 Kte, Cte, 2 Kte, Cte, Xu, Xu, Xu, Xu, Xu, Xu, Xu, Xu, Xu, Xu, Uh, Uu, Xu
Xu, Xu, Xu, Xu, Uh, Cte, Uu, Cte, Uh, Xu, Xu, Xu, Xu, Xu, Xu, 3 Kte, Cte, Uu, Uu, Uh, Xu, Xu
Xu, Xu, Xu, Xu, Uh, Uu, Uu, Uu, Uu, Xu, Xu, Xu, Xu, Xu, Xu, Xu, Xu, Xu, Xu, Xu, Xu, Xu
