Cud, Cud, Cud, Xu, Xu, Xu, Xu, Xu, Xu, Xu, Xu, Xu, Xu, Xu, Xu, Xu, Xu, Xu, Xu, Xu, Xu, Xu
Cud, 3 Kud, Cud, Cud, Cud, Xu, Xu, Xu, Xu, Xu, Xu, Xu, Xu, Xu, Ur, Xu, Xu, Xu, Xu, Xu, Xu, Xu
Cud, Cud, Ur, Cud, Cud, Cud, Ur, Ur, Ur, Xu, Xu, Xu, Ur, Ur, Xu, Ur, Ur, Xu, Xu, Xu, Xu, Xu
Cud, Cud, Cud, Ur, Ur, Ur, Ur, Ur, Xu, Ur, Ur, Ur, Xu, Xu, Ur, Ur, Xu, Ur, Xu, Xu, Xu, Xu
Xu, Cud, Cud, Cud, Ur, Ur, Ur, Uu, Rr, Xu, Xu, Xu, Uu^Vud, Uu^Vud, Ur, Uu^Vud, Xu, Ur, Xu, Xu, Xu, Xu
Xu, Xu, Ur, Ur, Ur, Ur, Uu, Uu, Rr, Mm, Mm, Xu, Xu, Ur, Uu^Vud, Xu, Uu^Vud, Ur, Uu^Vud, Xu, Xu, Xu
Xu, Xu, Xu, Ur, Ur, Xu, Xu, Rr, Mm, Rr, Mm, Mm, Mm, Xu, Xu, Xu, Uu^Tf, Ur, Ur, Uu^Vud, Xu, Xu
Xu, Xu, Xu, Xu, Ur, Uu^Vud, Xu, Mm, Mm, Rr, Rr, Hh, Hh^Vhh, Mm, Gs^Fp, Xu, Xu, Uu^Tf, Ur, Uu^Tf, Xu, Xu
Xu, Xu, Xu, Uu^Vud, Ur, Uu^Vud, Xu, Mm, Mm, Hh, Hh, Rr, Rr, Gs^Fp, Hh^Vhh, Gs^Fp, Mm, Xu, Ur, Xu, Xu, Xu
Xu, Uu^Vud, Ur, Ur, Xu, Xu, Mm, Mm, Hh^Vhh, Mm, Hh, Gs^Fp, Rr, Gs^Fp, Hh^Fp, Gs^Fmw, Mm, Xu, Xu, Ur, Xu, Xu
Xu, Uu^Vud, Ur, Uu^Vud, Uu^Tf, Xu, Mm, Mm, Mm, Hh, Hh^Fp, Gs^Fp, Rr, Hh, Gs^Fp, Gs^Fp, Mm, Mm, Mm, Uu, Xu, Xu
Xu, Uu^Tf, Ur, Uu^Tf, Uu^Tf, Xu, Gs^Fp, Mm, Mm, Mm, Gs^Fmw, Gs^Fp, Rr, Hh, Mm^Vhh, Mm, Hh^Vhh, Hh, Hh, Rr, Hh^Vhh, Xu
Xu, Xu, Ur, Xu, Xu, Xu, Mm, Gs^Fp, Gs^Fp, Gs^Fmw, Mm^Vhh, Gs^Fp, Rr, Hh, Hh, Mm, Mm, Mm, Hh, Rr, Gs^Fp, Mm
Xu, Xu, Xu, Ur, Uu, Xu, Mm, Mm, Gs^Fmw, Gs^Fp, Mm, Mm, Mm, Rr, Rr, Gs^Fp, Mm, Mm, Hh, Rr, Gs^Fp, Gs^Fp
Gs^Fp, Xu, Mm, Xu, Mm, Rr, Rr, Hh^Vhh, Gs^Fp, Gs^Fp, Mm, Mm, Gs^Fmw, Gs^Fp, Rr, Gs^Fp, Mm, Hh^Vhh, Rr, Rr, Gs^Fp, Gs^Fmw
Gs^Fp, Gs^Fp, Mm, Mm, Mm, Mm, Hh, Rr, Rr, Mm, Mm, Hh^Vhh, Mm, Gs^Fp, Rr, Gs^Fp, Rr, Rr, Hh, Mm, Hh^Vhh, Gs^Fmw
Gs^Fp, Gs^Fp, Gs^Fp, Hh^Vhh, Gs^Fmw, Gs^Fmw, Hh, Mm, Rr, Mm, Mm, Mm, Mm, Gs^Fp, Rr, Rr, Hh, Hh, Hh, Mm, Mm, Gs^Fp
Gs^Fp, Gg^Fet, Gs^Fp, Gs^Fp, Hh^Vhh, Hh^Fp, Hh, Mm, Mm, Rr, Rr, Mm, Rr, Rr, Hh, Rr, Hh, Mm, Hh, Mm, Mm, Mm
Gs^Fp, Gs^Fp, Mm, Gs^Fp, Hh, Hh, Mm, Hh, Mm, Mm, Hh, Rr, Hh, Cte, Cte, Cte, Cte, Cte, Hh, Hh^Vhh, Mm, Mm
Ww, Ww, Mm, Mm, Hh^Vhh, Mm, Mm, Hh^Vhh, Mm, Mm, Hh^Vhh, Hh, Hh, Cte, 1 Kte, Cte, 2 Kte, Cte, Mm, Hh, Mm, Mm
Wo, Wo, Wo, Ww, Hh, Mm, Mm, Mm, Mm, Mm, Mm, Mm, Mm, Cte, Hh, Rr, Rr, Cte, Hh, Mm, Mm, Mm
Wo, Wo, Wo, Ww, Mm, Mm, Mm, Mm, Mm, Mm, Mm, Mm, Mm, Hh, Hh, Hh, Rr, Hh, Hh, Mm, Mm, Mm
