Ms, Ms, Ms, Ms, Xu, Xu, Xu, Xu, Xu, Xu, Xu, Xu, Co, Co, Co, Co, Co, Co, Co, Co, Uu^Tf, Uu^Tf
Ms, Ms, Ms, Ms, Xu, Xu, Xu, Xu, Xu, Xu, Xu, Co, Co, Co, Co, 3 Ko, Co, Co, Co, Co, Uu, Uu^Tf
Ms, Ms, Ms, Ms, Ms, Ms, Ms, Xu, Xu, Xu, Uh, Co, Uu, Co, Uu, Co, Uu, Co, Uu, Co, Uh, Uh
Ms, Ms, Ms, Ms^Voa, Ms, Ms, Ms, Xu, Xu, Uu, Uh, Uu^Tf, Uu^Tf, Uu, Uu^Tf, Uu, Uu^Tf, Uu^Tf, Uu^Tf, Uh, Xu, Xu
Ms, Ms, Ms^Voa, Ms, Ms, Ms, Ms, Xu, Xu, Uh, Uu, Uu^Vu, Uu, Uu^Vu, Uu, Uu, Uu, Uu^Vu, Uh, Uu^Vu, Xu, Xu
Ms, Ms, Ms, Ha, Ms^Voa, Ms, Ms, Ms, Ms, Xu, Ms, Ms, Ms, Ms, Ms, Ms, Ms, Ms, Xu, Xu, Xu, Xu
Ms, Ms, Aa, Ha, Ha, Ms, Ms, Ms, Ms, Ms, Ms, Ms, Ms, Ms, Ms, Ms, Ms, Ms, Ms, Ms, Ms, Xu
Aa, Aa, Aa, Aa, Ms, Ms, Ms, Ms, Ms, Ms, Ms, Ms, Ms, Ms, Ms, Ms, Ms, Ms, Ms, Ms, Ms, Ms
Aa, Aa, Aa^Esa, Ms, Ms, Ms, Ms, Ms, Ms, Ms, Ms, Ms, Ms, Ms, Ms, Ha, Ms, Ms^Voa, Ms, Ms, Ms, Ms
Aa, Aa, Aa, Ms, Ha, Ms, Ms, Ms, Ms, Ha, Ms, Ms, Ms, Ms, Ha, Ha, Ms, Ms, Ms, Ms, Ms^Voa, Ms
Aa, Aa, Aa, Aa, Ha, Ms, Ms, Ms, Aa, Ha, Aa, Aa, Re, Aa^Voa, Ss, Ha, Ms, Ms, Ms, Ms, Ms, Ms
Aa, Aa, Ms, Aa, Aa, Ms, Aa, Ms, Aa, Aa, Aa, Aa^Esa, Re, Aa, Ss, Xu, Xu, Ms, Ms, Ms, Ms, Ms
Ms, Ms, Ms, Aa, Aa, Aa, Aa^Esa, Aa, Aa, Aa, Re, Re, Xu, Re, Re, Uh, Uh, Xu, Ms, Ms, Ms^Voa, Ms
Ms, Ms, Ms^Voa, Ms, Aa, Aa, Aa, Aa^Esa, Aa, Aa, Aa, Aa, Xu, Uh, Uh, Uh, Uu^Vu, Xu, Ms, Ms, Ms, Ms
Ms, Ms, Ms, Ms, Ms, Ms, Ha, Ha, Aa, Re, Ms, Ms, Xu, Uu^Vu, Uu^Vu, Uu, Uh, Xu, Xu, Ms, Ms, Ms
Ms, Ms, Ms, Ms, Ms^Voa, Ms, Aa, Aa, Re, Re, Aa, Ms, Ms, Xu, Xu, Uu, Uu, Uu^Vu, Xu, Ms, Ms, Ms
Ms, Ms, Ms, Ms, Ms, Ha, Hhd, Re, Aa, Aa, Ms, Ms, Ms, Ms, Xu, Uu^Vu, Uh, Uu^Vu, Xu, Ms, Ms^Voa, Ms
Ms, Ms, Cte, Cte, Cte, Ha, Hhd, Re, Aa^Esa, Ms, Ms, Ms^Voa, Ms, Ms, Xu, Uu, Ms, Uh, Xu, Ms, Ms, Ms
Hhd, Hhd, Aa, 1 Kte, Cte, Hhd, Hhd, Re, Aa, Aa, Ms, Ms, Re, Ha, Ha, Ms, Ms^Voa, Ms, Ms, Ms, Ms^Voa, Ms
Hhd, Aa, Aa, Cte, 2 Kte, Cte, Aa, Aa, Aa, Aa, Re, Re, Re, Ha^Voa, Ha, Ha, Ms, Ms, Ms, Ms, Ms, Ms
Aa, Aa, Aa, Aa, Cte, Cte, Hhd, Hhd, Hhd, Re, Hhd, Hhd, Hhd, Ha, Ms, Ms, Ms, Ms, Ms, Ms^Voa, Ms, Ms
Aa, Aa, Hhd, Hhd, Hhd, Hhd, Hhd, Hhd, Hhd, Hhd, Hhd, Hhd, Hhd, Ms, Ms, Ms, Ms, Ms, Ms, Ms, Ms, Ms
