Ms, Ms, Ms, Ms, Xu, Xu, Xu, Xu, Xu, Xu, Xu, Xu, Uu, Cud, Cud, Cud, Cud, Cud, Uu^Tf, Uu, Uu^Tf, Uu^Tf
Ms, Ms, Ms, Ms, Xu, Xu, Xu, Xu, Xu, Xu, Xu, Uu, Uu, Cud, Cud, 3 Kud, Cud, Cud, Uu^Tf, Uh, Uu^Vu, Uu^Tf
Ms, Ms, Ms, Ms, Ms, Ms, Ms, Xu, Xu, Xu, Uh, Uu^Tf, Uu^Vu, Uu, Uu, Cud, Uu, Uu, Uu^Vu, Uh, Uh, Uh
Ms, Ms, Ms, Ms, Ms, Ms, Ms, Xu, Xu, Uu^Vu, Uh, Uu^Tf, Uu^Tf, Uu, Uu^Tf, Uu, Uu^Tf, Uu^Tf, Uu^Tf, Uh, Xu, Xu
Ms, Ms, Ms, Ms, Ms, Ms, Ms, Xu, Xu, Uh, Uu, Uu, Uu, Uu, Uu, Uu, Uu, Uu, Uh, Uu^Vu, Xu, Xu
Ms, Ms, Ms, Ha, Ms, Ms, Ms, Ms, Ms, Xu, Ms, Ms, Ms, Ms, Ms, Ms, Ms, Ms, Xu, Xu, Xu, Xu
Ms, Ms, Aa, Ha, Ha, Ms, Ms, Ms, Ms, Ms, Ms, Ms, Ms, Ms, Ms, Ms, Ms, Ms, Ms, Ms, Ms, Xu
Aa, Aa, Aa, Aa, Ms, Ms, Ms, Ms, Ms, Ms, Ms, Ms, Ms, Ms, Ms, Ms, Ms, Ms, Ms, Ms, Ms, Ms
Aa, Aa, Aa^Esa, Ms, Ms, Ms, Ms, Ms, Ms, Ms, Ms, Ms, Ms, Ms, Ms, Ha, Ms, Ms, Ms, Ms, Ms, Ms
Aa, Aa, Aa, Ms, Ha, Ms, Ms, Ms, Ms, Ha, Ms, Ms, Ms, Ms, Ha, Ha, Ms, Ms, Ms, Ms, Ms, Ms
Aa, Aa, Aa, Aa, Ha, Ms, Ms, Ms, Aa, Ha, Aa, Aa, Aa, Aa^Voa, Aa, Ha, Ms, Ms, Ms, Ms, Ms, Ms
Aa, Aa, Ms, Aa, Aa, Ms, Aa, Ms, Aa, Aa, Aa, Aa^Esa, Aa, Aa, Aa, Xu, Xu, Ms, Ms, Ms, Ms, Ms
Ms, Ms, Ms, Aa, Aa, Aa, Aa^Esa, Aa, Aa, Aa, Aa, Aa, Xu, Aa, Aa, Uh, Uh, Xu, Ms, Ms, Ms, Ms
Ms, Ms, Ms^Voa, Ms, Aa, Aa, Aa, Aa^Esa, Aa, Aa, Aa, Aa, Xu, Uh, Uh, Uh, Uh, Xu, Ms, Ms, Ms, Ms
Ms, Ms, Ms, Ms, Ms, Ms, Ha, Ha, Aa, Aa, Ms, Ms, Xu, Uu, Uu^Vu, Uu, Uh, Xu, Xu, Ms, Ms, Ms
Ms, Ms, Ms, Ms, Ms^Voa, Ms, Aa, Aa, Aa, Aa, Aa, Ms, Ms, Xu, Xu, Uu, Uu, Uu^Vu, Xu, Ms, Ms, Ms
Ms, Ms, Ms, Ms, Ms, Ha, Hhd, Aa, Aa, Aa, Ms, Ms, Ms, Ms, Xu, Uu, Uh, Uh, Xu, Ms, Ms, Ms
Ms, Ms, Cte, Cte, Cte, Ha, Hhd, Aa, Aa^Esa, Ms, Ms, Ms^Voa, Ms, Ms, Xu, Uu, Ms, Uh, Xu, Ms, Ms, Ms
Ha, Hhd, Aa, 1 Kte, Cte, Hhd, Hhd, Aa, Aa, Aa, Ms, Ms, Aa, Ha, Ha, Ms, Ms^Voa, Ms, Ms, Ms, Ms, Ms
Hhd, Aa, Aa, Cte, 2 Kte, Cte, Aa, Aa, Aa, Aa, Aa, Aa, Aa, Ha, Ha, Ha, Ms, Ms, Ms, Ms, Ms, Ms
Aa, Aa, Aa, Aa, Cte, Cte, Hhd, Aa, Hhd, Aa, Hhd, Hhd, Hhd, Ha, Ms, Ms, Ms, Ms, Ms, Ms, Ms, Ms
Aa, Aa, Hhd, Hhd, Hhd, Hhd, Hhd, Hhd, Hhd, Hhd, Hhd, Hhd, Hhd, Ms, Ms, Ms, Ms, Ms, Ms, Ms, Ms, Ms
