Xu, Xu, Xu, Xu, Xu, Xu, Xu, Xu, Xu, Xu, Xu, Xu, Xu, Xu, Xu, Xu, Xu, Xu, Xu, Xu, Xu, Xu, Xu
Xu, Xu, Xu, Xu, Xu, Xu, Uu^Vu, Xu, Xu, Xu, Cud, 6 Kud, Cud, Xu, Xu, Xu, Uu^Vu, Xu, Xu, Xu, Xu, Xu, Xu
Xu, Xu, Xu, Xu, Xu, Uu, Uu, Uu, Xu, Cud, Cud, Cud, Cud, Cud, Xu, Uu, Uu, Uh, Xu, Xu, Xu, Xu, Xu
Xu, Xu, Xu, Xu, Uh, Uh, Ur, Uu, Xu, Cud, Cud, Cud, Cud, Cud, Xu, Ur, Uh, Uu, Xu, Xu, Xu, Xu, Xu
Xu, Xu, Xu, Xu, Uh, Uu, Ur, Uh, Xu, Cud, Cud, Cud, Cud, Cud, Xu, Ur, Uh, Uu, Uh, Xu, Xu, Xu, Xu
Xu, Xu, Xu, Xu, Uu, Uu, Uu, Uh, Uu, Xu, Xu, Cud, Xu, Xu, Uh, Ur, Uh, Uu, Uu, Xu, Xu, Xu, Xu
Xu, Xu, Xu, Xu, Uh, Uu^Vu, Uu, Uu, Uu, Uh, Ur, Xu, Ur, Uh, Uu^Es, Uu^Es, Uh, Uu^Vu, Uu, Uu, Xu, Xu, Xu
Xu, Xu, Xu, Uu, Uh, Uu, Uh, Uu, Uu, Uh, Uu, Ur, Uu^Es, Uh, Uu^Es, Uu^Es, Uh, Uu, Uh, Ur, Uu^Vu, Xu, Xu
Xu, Xu, Xu, Ur, Uu, Uu, Xu, Xu, Xu, Uu, Uh, Ur, Uu^Es, Uu^Es, Xu, Xu, Uh, Uh, Uu, Ur, Xu, Xu, Xu
Xu, Xu, Xu, Ur, Uu, Xu, Xu, Xu, Xu, Xu, Uu, Ur, Uu^Es, Xu, Xu, Xu, Xu, Xu, Uu, Uh, Uh, Xu, Xu
Xu, Xu, Uu, Uu, Ur, Uu^Vu, Xu, Xu, Xu, Xu, Uh, Ur, Uh, Xu, Xu, Xu, Xu, Xu, Uu^Vu, Uh, Uh, Xu, Xu
Xu, Xu, Uu^Vu, Uu, Ur, Uh, Xu, Uu^Vu, Xu, Xu, Uh, Ur, Uh, Xu, Xu, Uu^Vu, Uh, Xu, Uu, Uu, Ur, Uh, Xu
Xu, Xu, Uu, Uh, Ur, Uh, Uu, Uh, Uu, Xu, Uu, Ur, Uu, Xu, Uh, Uu, Uh, Uh, Uu, Uh, Ur, Uh, Xu
Xu, Uh, Uu, Uh, Uu, Uu, Xu, Uh, Uu, Uu, Cud, Cud, Cud, Uu, Uu, Uu, Xu, Uh, Xu, Xu, Uu, Uh, Xu
Qxua, Xu, Xu, Xu, Uh, Uu, Xu, Uu, Uh, Cud, Cud, 3 Kud, Cud, Cud, Uu, Xu, Xu, Uh, Uu^Vu, Xu, Xu, Xu, Qxua
Qxua, Qxua, Xu, Xu, Uh, Uu^Vu, Xu, Xu, Uh, Uu, Xu, Cud, Xu, Uh, Uu, Uh, Xu, Ur, Uh, Xu, Xu, Qxua, Qxua
Qxua, Qxua, Xu, Uu^Vu, Ur, Ur, Ur, Uu, Uh, Xu, Uu, Xu, Uu, Xu, Xu, Uh, Ur, Ur, Uh, Uu^Vu, Xu, Qxua, Qxua
Qxua, Qxua, Xu, Uh, Uh, Uh, Xu, Uu^Vu, Xu, Xu, Uh, Ur, Uu, Xu, Xu, Uu^Vu, Xu, Ur, Ur, Uu, Xu, Qxua, Qxua
Qxua, Qxua, Xu, Uu^Vu, Uh, Uu^Vu, Xu, Xu, Uu, Uh, Uu, Ur, Uh, Uh, Uh, Xu, Xu, Uu^Vu, Uh, Uu^Vu, Xu, Qxua, Qxua
Qxua, Qxua, Cud, Xu, Xu, Xu, Uh, Xu, Uu, Uh, Uu, Ur, Uu, Uu, Uh, Xu, Uu, Xu, Xu, Xu, Cud, Qxua, Qxua
Cud, Cud, Cud, Cud, Cud, Xu, Uh, Uu, Uh, Uu, Cud, Ur, Cud, Uu, Uh, Uu, Uh, Xu, Cud, Cud, Cud, Cud, Cud
Cud, 4 Kud, Cud, Cud, Cud, Xu, Uu, Uu, Uh, Cud, 1 Kud, Cud, 2 Kud, Cud, Uu, Uu, Uh, Xu, Cud, Cud, Cud, 5 Kud, Cud
Cud, Cud, Cud, Cud, Cud, Xu, Uh, Uu, Uu, Cud, Cud, Cud, Cud, Cud, Uh, Uu, Uh, Xu, Cud, Cud, Cud, Cud, Cud
