Xu, Xu, Xu, Xu, Xu, Xu, Xu, Xu, Xu, Xu, Cer, Cer, Cer, Cer, Cer, Xu, Xu, Xu, Xu, Xu, Xu, Xu
Cer, Cer, Uh, Xu, Xu, Xu, Xu, Xu, Xu, Xu, Cer, Cer, 4 Ker, Cer, Cer, Xu, Xu, Xu, Xu, Xu, Xu, Xu
Cer, Cer, Uh, Uu^Vu, Xu, Xu, Uu^Tf, Uu^Vu, Uh, Xu, Re, Uu, Uu, Uu, Uh, Xu, Xu, Xu, Xu, Xu, Xu, Xu
Cer, 5 Ker, Uu, Xu, Xu, Uu^Tf, Uh, Uu, Xu, Re, Uu, Uu^Vu, Uu, Re, Xu, Xu, Xu, Xu, Xu, Xu, Xu, Xu
Cer, Cer, Uu, Uh, Uu, Uh, Xu, Xu, Xu, Xu, Xu, Re, Uh, Re, Uu^Tf, Xu, Xu, Xu, Xu, Xu, Xu, Xu
Xu, Cer, Uu, Re, Re, Uu, Xu, Xu, Uh, Uu^Vu, Uu, Xu, Xu, Uu, Ww, Ww, Wo, Wo, Wo, Xu, Xu, Xu
Xu, Xu, Uh, Uu^Vu, Uu, Uu, Xu, Xu, Xu, Re, Re, Uu^Vu, Xu, Uu, Uu^Tf, Ww, Ww, Wo, Wo, Xu, Xu, Xu
Xu, Xu, Xu, Uh, Ww, Uh, Uu^Tf, Xu, Uu^Tf, Uu^Vu, Re, Uu, Uh, Re, Uu^Tf, Uu^Tf, Ww, Wo, Wo, Wo, Xu, Xu
Xu, Xu, Wo, Wo, Ww, Xu, Xu, Uu, Ww, Uu, Re, Uh, Re, Re, Cte, Uu^Tf, Xu, Ww, Wo, Wo, Xu, Xu
Xu, Xu, Wo, Wo, Ww, Xu, Xu, Uu^Tf, Wo, Ww, Uu^Tf, Re, Cte, Re, Cte, Uu^Tf, Xu, Ww, Ww, Xu, Xu, Xu
Xu, Xu, Xu, Wo, Ww, Ww, Re, Uu^Tf, Wo, Ww, Uu^Tf, Uu^Tf, Uu, Cte, 6 Kte, Uu, Xu, Uu^Vu, Re, Uu^Vu, Xu, Xu
Xu, Xu, Xu, Xu, Xu, Ww, Re, Ww, Wo, Uu^Tf, Xu, Xu, Xu, Re, Uu, Xu, Uu^Vu, Re, Re, Uu, Xu, Xu
Xu, Xu, Xu, Xu, Uu, Uu, Xu, Ww, Wo, Uu, Uu, Xu, Re, Re, Xu, Uu, Re, Re, Uu^Vu, Xu, Xu, Xu
Xu, Xu, Xu, Uh, Xu, Xu, Uu^Vu, Ww, Re, Uu, Xu, Re, Xu, Xu, Xu, Uu^Vu, Uu, Uu, Xu, Xu, Xu, Xu
Xu, Xu, Xu, Uu^Vu, Xu, Uu^Vu, Re, Re, Xu, Xu, Uu^Vu, Uu, Xu, Xu, Xu, Xu, Uu, Xu, Xu, Xu, Xu, Xu
Xu, Xu, Xu, Uu, Xu, Xu, Xu, Xu, Re, Uu, Xu, Xu, Xu, Xu, Xu, Uh, Tb^Tf, Xu, Xu, Xu, Xu, Xu
Xu, Xu, Xu, Uu, Uu, Uu, Re, Re, Xu, Uu, Uu, Xu, Xu, Uu^Vu, Uu^Vu, Xu, Re, Xu, Xu, Xu, Xu, Xu
Xu, Xu, Xu, Uu, Cte, Re, Uu, Xu, Xu, Xu, Xu, Uu^Tf, Xu, Re, Re, Xu, Re, Xu, Uh, Xu, Xu, Xu
Xu, Xu, Xu, Cte, Cte, Cte, Uu, Xu, Xu, Xu, Xu, Uu^Tf, Xu, Uu^Vu, Re, Xu, Xu, Re, Uu, Xu, Xu, Xu
Xu, Xu, Xu, 1 Kte, Cte, 2 Kte, Uu, Xu, Xu, Xu, Xu, Uu, Uu, Xu, Uu, Xu, Re, Xu, Re, Cer, 3 Ker, Cer
Xu, Xu, Xu, Uh, Re, Uh, Uu, Xu, Xu, Xu, Xu, Xu, Xu, Uu^Tf, Xu, Uu, Xu, Re, Uu, Cer, Cer, Cer
Xu, Xu, Xu, Uh, Re, Uh, Xu, Xu, Xu, Xu, Xu, Xu, Xu, Xu, Xu, Xu, Xu, Xu, Uh, Cer, Cer, Cer
