Mm, Mm, Mm, Mm, Mm, Mm, Mm, Mm, Mm, Mm, Mm, Mm, Mm, Mm, Mm, Mm, Mm, Re, Ko, Ko, Ko, Ko
Mm, Mm, Mm, Mm, Mm, Mm, Ss^Vhs, Hh, Hh, Mm, Mm, Mm, Mm, Mm, Hh, Hh, Hh, Re, Ko, 5 Ko, Ss, Ko
Mm, Mm, Mm, Ss, Ss, Ss, Ss, Ss^Vhs, Mm, Mm, Mm, Mm, Hh, Mm, Ss, Ss^Vhs, Ss, Re, Re, Ko, Ss, Ko
Mm, Mm, Hh^Fp, Ss^Vhs, Re, Ss^Vhs, Re, Re, Mm, Mm, Ss, Hh, Ss, Ss, Ss, Ss, Re, Ss, Ss, Re, Ss^Vhs, Ss
Hh^Fp, Hh^Fp, Ss, Re, Re, Ss, Ww^Es, Re, Ss, Ss, Ww^Es, Ss, Re, Ss, Re, Re, Ss^Vhs, Ss, Re, Ss, Hh, Hh
Hh^Fp, Hh^Fp, Ss, Re, Ss, Re, Ss, Re, Ss, Ss, Ss, Re, Ss, Re, Re, Ss, Ss, Re, Ss, Ss, Mm, Mm
Hh^Fp, Ss, Ss, Ss, Ss^Vhs, Ss, Ss, Ss, Ss, Ss^Vhs, Ss, Ss, Re, Ss, Re, Ww^Es, Ss, Ss, Mm, Mm, Mm, Mm
Re, Re, Re, Ss, Ss, Re, Re, Re, Ss, Ss, Re, Ss, Re, Ss, Ss^Vhs, Ss, Hh, Mm, Hh, Hh, Hh, Mm
Co, Co, Co, Re, Ss, Re, Ss, Ww^Es, Re, Re, Cte, Re, Re, Re, Re, Ss, Ss, Ss^Vhs, Re, Re, Co, Hh
Co, 3 Ko, Co, Re, Ss, Ss^Vhs, Ss, Re, Cte, Cte, Cte, Cte, Cte, Re, Ss, Ss, Re, Ss, Re, Co, 4 Ko, Co
Re, Co, Re, Re, Ss, Ss, Re, Re, Cte, Cte, Cte, 2 Kte, Cte, Re, Ss, Re, Ss, Ss, Re, Co, Co, Co
Ss, Re, Ss, Ss^Vhs, Ss, Ss, Re, Cte, Cte, 1 Kte, Cte, Cte, Cte, Re, Ss, Re, Re, Ss^Vhs, Ss, Re, Re, Re
Ss, Ss, Ww^Es, Ss, Ss, Ss, Ss, Re, Re, Cte, Cte, Cte, Re, Re, Ss, Re, Ss, Re, Ss, Ss, Ss^Vhs, Mm
Ss, Ss, Ss, Re, Ss, Ss^Vhs, Re, Ss, Ss, Re, Re, Re, Ss, Ss, Ss, Ss^Vhs, Ss, Ww^Es, Ss, Ss, Mm, Mm
Ss, Ss, Re, Re, Re, Ss, Re, Ss, Ss, Ss, Ss, Ss, Re, Re, Ss, Ss, Mm, Ss, Mm, Mm, Mm, Mm
Hh, Ss, Re, Ss, Ss, Re, Ss, Ss, Re, Re, Re, Ss^Vhs, Re, Ss, Mm, Ss, Mm, Mm, Mm, Mm, Mm, Mm
Hh, Ss, Ss, Ss, Ss, Ss, Re, Ww^Es, Ss, Ss, Re, Ss, Ss, Ss, Ss, Mm, Ss^Vhs, Mm, Ss^Vhs, Mm, Mm, Mm
Hh, Hh, Ss^Vhs, Ss, Re, Re, Re, Ss, Re, Ss, Ss, Re, Ww^Es, Re, Re, Ss, Ss, Ss, Ss, Hh^Fp, Mm, Mm
Hh, Ss, Re, Ss, Ss, Ss, Ss, Re, Ss, Ss, Mm, Ss, Ss, Re, Ss, Re, Re, Re, Ss, Hh^Fp, Mm, Mm
Re, Re, Ko, Re, Re, Ss, Ss, Ss, Ss, Ss, Hh, Mm, Ss, Ss, Ss, Ss^Vhs, Re, Ss, Hh^Fp, Hh^Fp, Hh^Fp, Mm
Re, Re, 6 Ko, Ko, Ss, Ss, Ss^Vhs, Hh, Mm, Hh, Mm, Mm, Mm, Mm, Ss, Ss, Ss, Ss^Vhs, Ss, Ss, Hh^Fp, Hh^Fp
Ko, Ko, Ko, Ko, Ss, Ss, Hh, Hh, Mm, Mm, Mm, Mm, Mm, Mm, Mm, Mm, Mm, Ss, Ss, Ss, Hh^Fp, Hh^Fp
