Mm, Mm, Mm, Mm, Mm, Mm, Mm, Mm, Mm, Mm, Mm, Mm, Ss^Vhs, Ss, Ss, Ss, Ss, Ss, Ss, Ss, Mm, Ss
Mm, Mm, Hh, Hh, Mm, Mm, Hh, Hh, Mm, Mm, Gll^Fp, Ss, Ss, Ss, Ss, Ss, Chs, Ss, Ss, Ss, Mm, Mm
Mm, Mm, Hh, Ss, Ss, Ss, Mm, Mm, Hh, Hh, Gll^Fp, Ss, Ss, Ss, Ss^Vhs, Ss, Ss, 5 Khs, Ss, Ss, Mm, Mm
Mm, Mm, Ss, Ss, Ss^Vhs, Ss, Ss, Ss^Vhs, Ss, Ss, Ss, Ss, Ss, Ss, Ss, Ss, Ss, Chs, Mm, Mm, Mm, Mm
Mm, Mm, Gll^Fp, Ss, Ss, Ss, Gll^Fp, Ss, Ss, Ss, Ss^Vhs, Ss, Ss, Ss, Ss, Ss^Vhs, Ss, Hh, Mm, Mm, Mm, Mm
Mm, Mm, Gll^Fp, Gll^Fp, Gll^Fp, Ss, Ss, Ss, Ss, Hhd, Ss, Ss, Ss, Ss, Ss, Ss, Ss, Hh, Hh, Gll^Fp, Mm, Mm
Mm, Hh, Mm, Hhd, Ss, Ss, Ss^Vhs, Ss, Ss, Ss, Ss, Ss, Ss, Hhd, Hhd, Ss, Ss, Ss, Ss, Gll^Fp, Hh, Mm
Mm, Mm, Ss, Ss, Chs, Ss, Ss, Ss, Ss, Ss, Ss, Ss^Vhs, Ss, Ss, Ss, Ss^Vhs, Ss, 4 Khs, Ss, Ss^Vhs, Hh, Mm
Mm, Mm, Hh, 3 Khs, Ss, Ss, Ss, Ss, Ss, Ss, Ss, Ss, Ss, Ss, Ss, Ss, Ss, Chs, Ss, Ss, Mm, Mm
Hh, Hh, Ss, Chs, Ss, Ss, Ss^Vhs, Ss, Ss, Ss, Cte, Ss, Cte, Ss, Ss, Ss, Ss, Ss, Ss, Hh, Mm, Mm
Ss, Ss, Ss^Vhs, Ss, Ss, Ss, Ss, Ss, Ss, Cte, Cte, 2 Kte, Ss, Ss, Ss, Ss, Ss^Vhs, Ss, Ss, Mm, Mm, Mm
Ss, Ss, Ss, Ss, Ss, Ss, Ss, Ss, Cte, 1 Kte, Cte, Cte, Ss, Ss, Ss, Ss, Ss, Ss, Mm, Mm, Mm, Mm
Ss, Ss, Mm, Ss, Ss, Hh, Ss, Ss, Ss, Ss, Ss, Ss, Ss, Ss, Ss, Ss, Ss, Hhd, Ss^Vhs, Hh, Mm, Mm
Mm, Mm, Mm, Hh, Ss, Ss^Vhs, Ss, Ss, Ss, Ss, Ss, Ss, Hhd, Ss^Vhs, Ss, Ss, Hhd, Ss, Ss, Hh, Mm, Mm
Mm, Mm, Mm, Mm, Mm, Hh, Ss, Ss, Ss, Ss, Ss, Ss, Ss, Ss, Gll^Fp, Ss, Gll^Fp, Ss, Ss, Hh, Mm, Mm
Mm, Mm, Mm, Mm, Hh, Gll^Fp, Ss, Ss, Ss, Ss^Vhs, Ss, Ss, Ss, Ss, Ss, Ss, Hhd, Ss, Ss^Vhs, Ss, Mm, Mm
Mm, Mm, Hh, Hh, Ss, Gll^Fp, Ss, Ss^Vhs, Ss, Hhd, Ss, Ss, Hhd, Ss, Ss^Vhs, Ss, Gll^Fp, Hhd, Mm, Mm, Mm, Mm
Mm, Mm, Hh, Ss, Ss^Vhs, Ss, Ss, Ss, Ss, Ss, Mm, Gll^Fp, Mm, Ss, Ss, Ss, Hhd, Hhd, Mm, Mm, Mm, Mm
Mm, Mm, Mm, Mm, Chs, Ss, Ss, Ss, Ss, Ss, Mm, Mm, Hhd, Hhd, Ss, Ss, Mm, Mm, Hhd, Hhd, Mm, Mm
Mm, Mm, Ss, Ss, 6 Khs, Chs, Ss, Ss^Vhs, Ss, Mm, Mm, Mm, Hhd, Ss, Ss, Ss^Vhs, Ss, Ss, Ss^Vhs, Mm, Mm, Mm
Mm, Mm, Ss, Ss, Ss, Ss, Mm, Ss, Mm, Ss, Mm, Mm, Mm, Mm, Mm, Ss, Hh, Ss, Mm, Mm, Mm, Mm
Ss, Ss, Ss, Ss, Ss, Mm, Mm, Mm, Mm, Mm, Mm, Mm, Mm, Mm, Mm, Mm, Mm, Mm, Mm, Mm, Mm, Mm
