Cud, Cud, Cud, Uu, Xu, Xu, Xu, Xu, Xu, Xu, Xu, Xu, Xu, Xu, Xu, Xu, Xu, Xu, Uu, Cud, Cud, Cud
Cud, 3 Kud, Cud, Uu, Xu, Xu, Xu, Xu, Xu, Xu, Xu, Xu, Xu, Xu, Xu, Xu, Xu, Xu, Uu, Cud, 4 Kud, Cud
Cud, Cud, Cud, Uu, Xu, Xu, Xu, Xu, Xu, Xu, Xu, Xu, Xu, Xu, Xu, Uh, Uh, Xu, Ur, Cud, Cud, Cud
Cud, Cud, Uu, Ur, Xu, Xu, Uh, Xu, Xu, Xu, Xu, Xu, Xu, Xu, Uh, Uu, Uu, Xu, Ur, Ur, Uu, Cud
Uu, Uu, Xu, Ur, Ur, Xu, Uh, Xu, Xu, Uu, Uu, Uu, Uu, Xu, Xu, Uu, Ur, Ur, Xu, Xu, Xu, Uu
Xu, Xu, Xu, Xu, Xu, Ur, Ur, Xu, Uu, Uu, Xu, Xu, Xu, Uu, Uu, Uu, Xu, Xu, Uu^Vu, Xu, Xu, Xu
Xu, Xu, Xu, Xu, Uh, Xu, Uu, Uu, Xu, Xu, Cud, Cud, Cud, Xu, Xu, Uu, Uu, Xu, Uh, Xu, Xu, Xu
Xu, Xu, Xu, Uh, Uu^Vu, Xu, Ur, Xu, Cud, Cud, Cud, 5 Kud, Cud, Cud, Cud, Xu, Uu, Uu, Uu^Vu, Uu, Xu, Xu
Xu, Xu, Xu, Uh, Uu, Uu, Ur, Xu, Cud, Cud, Cud, Cud, Cud, Cud, Cud, Xu, Uu, Xu, Uu, Uh, Xu, Xu
Xu, Xu, Uh, Uu^Vu, Uh, Xu, Uu, Xu, Cud, Cud, Cud, Cud, Cud, Cud, Cud, Xu, Uu, Xu, Xu, Uh, Uu^Vu, Xu
Xu, Xu, Xu, Uu, Xu, Xu, Uh, Xu, Cud, Cud, Cud, Cud, Cud, Cud, Cud, Xu, Uh, Xu, Xu, Xu, Xu, Xu
Xu, Xu, Xu, Uh, Xu, Xu, Uh, Xu, Xu, Xu, Xu, Xu, Xu, Xu, Xu, Xu, Uh, Uh, Ur, Xu, Xu, Xu
Xu, Xu, Xu, Uu^Vu, Xu, Xu, Uu, Uh, Uu, Uu, Uu, Ur, Ur, Uu, Uu, Uh, Qxua, Uu^Vu, Ur, Xu, Xu, Xu
Xu, Xu, Xu, Xu, Xu, Uh, Uu^Vu, Qxua, Qxua, Uh, Uh, Uu^Vu, Ur, Uh, Qxua, Qxua, Qxua, Uu, Xu, Xu, Xu, Xu
Xu, Xu, Xu, Xu, Xu, Uh, Uu, Qxua, Qxua, Uh, Uu, Uu, Qxua, Uh, Uu, Qxua, Uu, Uu, Uh, Xu, Xu, Xu
Xu, Xu, Xu, Xu, Xu, Xu, Ur, Uu, Uh, Uu, Uu, Qxua, Uh, Uh, Uu, Qxua, Uh, Xu, Uh, Xu, Xu, Xu
Xu, Xu, Xu, Qxua, Xu, Ur, Qxua, Uu, Uu, Uu, Qxua, Qxua, Uu, Uu^Vu, Qxua, Uh, Qxua, Xu, Uu^Vu, Xu, Xu, Xu
Xu, Xu, Qxua, Qxua, Uh, Uh, Qxua, Uh, Uu^Vu, Uh, Uu, Uu, Uu, Ur, Uu, Qxua, Ur, Ur, Qxua, Qxua, Xu, Xu
Xu, Xu, Xu, Qxua, Qxua, Uu^Vu, Uu, Uh, Ur, Ur, Cte, Cte, Cte, Ur, Uh, Uh, Qxua, Qxua, Qxua, Xu, Xu, Xu
Xu, Xu, Xu, Qxua, Qxua, Uh, Qxua, Uh, Ur, Cte, 1 Kte, Cte, 2 Kte, Cte, Uh, Uh, Qxua, Qxua, Xu, Xu, Xu, Xu
Xu, Xu, Xu, Xu, Qxua, Qxua, Qxua, Uu, Ur, Cte, Uu, Cte, Uh, Cte, Uh, Qxua, Qxua, Qxua, Xu, Xu, Xu, Xu
Xu, Xu, Xu, Xu, Qxua, Qxua, Qxua, Uh, Ur, Uu, Uu, Uu, Uu, Uu, Uh, Uh, Qxua, Qxua, Xu, Xu, Xu, Xu
