Cer, Cer, Cer, Xu, Qxu, Xu, Xu, Xu, Xu, Xu, Xu, Xu, Xu, Xu, Xu, Xu, Qxu, Uu, Ur, Cer, Cer, Cer
Cer, 4 Ker, Cer, Qxu, Uu^Vu, Qxu, Qxu, Xu, Qxu, Qxu, Qxu, Xu, Qxu, Xu, Xu, Xu, Qxu, Uu, Ur, Cer, 5 Ker, Cer
Cer, Cer, Cer, Uu, Xu, Xu, Xu, Qxu, Uu^Vu, Xu, Xu, Qxu, Uu^Vu, Qxu, Qxu, Xu, Qxu, Uu, Ur, Cer, Cer, Cer
Uu, Cer, Uu, Ur, Uu, Xu, Xu, Xu, Uu^Tf, Xu, Uh, Uh, Xu, Xu, Xu, Qxu, Uh, Uu, Ur, Cer, Uu, Cer
Uu, Uu, Qxu, Ur, Ur, Uh, Uh, Xu, Uu, Uu, Xu, Uu, Uu^Tf, Xu, Qxu, Qxu, Uu, Ur, Qxu, Uu, Uu, Uu
Xu, Xu, Qxu, Uu^Vu, Qxu, Ur, Ur, Uh, Xu, Xu, Uu^Vu, Xu, Uu, Xu, Uh, Qxu, Qxu^Bs/, Ur, Qxu, Xu, Uu, Uu
Xu, Xu, Qxu, Qxu, Uu, Uu, Ur, Xu, Xu, Uu^Tf, Uu^Vu, Xu, Xu, Uu, Uu, Ur, Uh, Qxu, Xu, Xu, Uu, Uu
Xu, Qxu, Qxu, Uu^Vu, Uu, Uh, Ur, Uh, Xu, Uu^Vu, Uu, Uh, Uh, Ur, Ur, Ur, Uh, Qxu, Xu, Uu^Vu, Wwg^Es, Wwg
Xu, Xu, Qxu, Ur, Uh, Uh, Uu^Vu, Ur, Ur, Uh, Uu, Uh, Ur, Uh, Uh, Xu, Xu, Uh, Uu^Tf, Uu^Tf, Wog^Es, Wog
Xu, Xu, Qxu, Ur, Uu, Xu, Xu, Uu, Uh, Uh, Uu, Uh, Ur, Uu, Uu, Uu^Vu, Xu, Uu, Uh, Uu^Vu, Wog^Es, Wog
Xu, Xu, Xu, Ur, Uu, Xu, Uu^Vu, Xu, Uu, Cte, 6 Kte, Cte, Ur, Uu, Uh, Uh, Uu, Ur, Uu, Wwg, Wog, Wog
Xu, Xu, Xu, Ur, Xu, Xu, Uu^Tf, Uu^Vu, Uh, Cte, Ur, Cte, Uu, Uu^Tf, Uh, Uu, Ur, Ur, Uu^Vu, Wwg^Es, Wog, Wog
Xu, Xu, Uu^Vu, Uh, Xu, Uu^Vu, Xu, Xu, Ur, Uh, Uu, Ur, Ur, Uu^Tf, Uu^Vu, Xu, Ur, Uh, Wwg, Wog^Es, Wog, Wog
Xu, Xu, Xu, Uh, Xu, Xu, Uu^Vu, Uu, Uu^Vu, Xu, Uu^Vu, Uu, Uh, Uh, Xu, Xu, Uu, Uu, Wwg^Es, Wog, Wog^Es, Wog
Xu, Xu, Xu, Uu, Uh, Xu, Uu, Ur, Xu, Xu, Uu^Tf, Uu^Vu, Xu, Ur, Uu, Xu, Uu, Uh, Xu, Wog, Wog, Wog
Xu, Xu, Xu, Xu, Uu, Xu, Uh, Ur, Xu, Uu^Vu, Xu, Xu, Uu^Vu, Ur, Ur, Uh, Xu, Xu, Xu, Xu, Wog, Wog
Xu, Xu, Xu, Xu, Uu^Vu, Uu, Ur, Uh, Xu, Xu, Uh, Uu, Uu, Uu, Uh, Uh, Uu^Vu, Xu, Xu, Uu^Vu, Wwg^Es, Wog
Xu, Xu, Xu, Xu, Uu, Ur, Uu^Vu, Xu, Uu, Uu, Uh, Xu, Uh, Xu, Xu, Ur, Ur, Xu, Xu, Uh, Uh, Wwg^Es
Xu, Xu, Cte, Cte, Ur, Ur, Uu, Uh, Uh, Xu, Uh, Uu^Tf, Uu, Xu, Xu, Xu, Uu, Ur, Ur, Uu, Cer, Uh
Xu, Xu, 1 Kte, Cte, Cte, Cte, Uu, Uu^Tf, Xu, Xu, Qxu, Uu^Vu, Qxu, Uu, Uh, Uu, Qxu, Qxu, Ur, Cer, Cer, Cer
Uu, Uu, Ur, Ur, 2 Kte, Cte, Xu, Uu^Tf, Xu, Xu, Xu, Qxu, Xu, Qxu, Qxu, Qxu, Xu, Xu, Ur, Cer, 3 Ker, Cer
Ur, Ur, Uu, Uu, Xu, Xu, Xu, Xu, Xu, Xu, Xu, Xu, Xu, Xu, Xu, Xu, Xu, Xu, Ur, Cer, Cer, Cer
