Xu, Xu, Xu, Xu, Xu, Xu, Xu, Xu, Xu, Xu, Xu, Xu, Xu, Xu, Xu, Xu, Xu, Uu, Uu, Uu, Uu, Uu
Xu, Xu, Xu, Xu, Xu, Xu, Xu, Xu, Xu, Xu, Xu, Xu, Xu, Xu, Xu, Xu, Uu, Uu, 1 Kte, Uu, Uu, Uu
Xu, Xu, Xu, Xu, Xu, Xu, Xu, Xu, Xu, Xu, Xu, Xu, Xu, Xu, Xu, Uu^Vu, Uu, Cte, Cte, 2 Kte, Uu, Xu
Xu, Xu, Xu, Xu, Xu, Xu, Xu, Xu, Xu, Xu, Xu, Xu, Xu, Xu, Xu, Uu^Vu, Uu, Cte, Cte, Cte, Uu, Xu
Xu, Xu, Xu, Xu, Xu, Xu, Xu, Xu, Xu, Xu, Xu, Xu, Xu, Xu, Uu, Xu, Ur, Uu, Uu, Uu, Xu, Xu
Xu, Xu, Xu, Xu, Xu, Xu, Xu, Uh, Xu, Uh, Uu^Tf, Xu, Uu^Tf, Uu^Vu, Ur, Ur, Xu, Uu, Xu, Xu, Xu, Xu
Xu, Xu, Xu, Xu, Xu, Xu, Xu, Uh, Uu, Uu^Vu, Uu^Tf, Uu^Tf, Qxu, Uu, Ur, Xu, Xu, Xu, Xu, Xu, Xu, Xu
Xu, Xu, Xu, Xu, Xu, Xu, Uu^Vu, Uu, Uu, Uu, Xu, Qxu, Qxu, Uu, Uu, Uu^Vu, Uh, Xu, Uh, Xu, Xu, Xu
Xu, Xu, Xu, Xu, Xu, Xu, Xu, Uh, Uu^Tf, Xu, Xu, Qxu, Qxu, Ur, Xu, Xu, Xu, Uh, Uu^Tf, Xu, Xu, Xu
Xu, Xu, Xu, Xu, Xu, Xu, Uu, Uh, Uu, Xu, Xu, Uu, Ur, Ur, Xu, Xu, Xu, Xu, Uu^Tf, Uu^Vu, Xu, Xu
Xu, Xu, Xu, Xu, Uu^Tf, Xu, Uu, Qxu, Qxu, Uu^Tf, Uu^Vu, Ur, Uu, Qxu, Qxu, Xu, Xu, Xu, Uu, Xu, Xu, Xu
Xu, Xu, Xu, Xu, Uu^Vu, Uu^Tf, Qxu, Qxu, Qxu, Uu^Tf, Ur, Uu^Tf, Qxu, Qxu, Qxu, Xu, Uu^Tf, Xu, Uh, Uh, Xu, Xu
Xu, Xu, Xu, Uu^Vu, Uu, Uu^Tf, Qxu, Qxu, Qxu, Uh, Ur, Uu^Tf, Qxu, Qxu, Qxu, Qxu, Uu, Uu^Vu, Uh, Xu, Xu, Xu
Xu, Xu, Xu, Uu^Tf, Uu^Tf, Uu, Uu^Tf, Qxu, Uu, Ur, Qxu, Uu^Vu, Uh, Qxu, Uu^Tf, Uu^Tf, Uh, Uu^Vu, Uu^Tf, Xu, Xu, Xu
Xu, Xu, Xu, Xu, Xu, Xu, Uu^Vu, Uu, Qxu, Qxu, Qxu, Qxu, Uh, Uu, Xu, Xu, Xu, Uu^Tf, Xu, Xu, Xu, Xu
Xu, Xu, Xu, Xu, Xu, Xu, Xu, Ur, Qxu, Qxu, Qxu, Uu^Tf, Uu^Vu, Xu, Xu, Xu, Xu, Xu, Xu, Xu, Xu, Xu
Xu, Xu, Xu, Xu, Xu, Xu, Xu, Ur, Qxu, Qxu, Qxu, Uu, Ur, Xu, Xu, Xu, Xu, Xu, Xu, Xu, Xu, Xu
Xu, Xu, Xu, Xu, Xu, Xu, Uu, Ur, Uu, Qxu, Ur, Ur, Xu, Xu, Xu, Xu, Xu, Xu, Xu, Xu, Xu, Xu
Xu, Xu, Xu, Xu, Xu, Uu^Vu, Cud, Cud, Cud, Uu, Xu, Uu^Vu, Xu, Xu, Xu, Xu, Xu, Xu, Xu, Xu, Xu, Xu
Xu, Xu, Xu, Xu, Xu, Uu, Cud, 3 Kud, Cud, Uu, Xu, Xu, Xu, Xu, Xu, Xu, Xu, Xu, Xu, Xu, Xu, Xu
Xu, Xu, Xu, Xu, Xu, Uu, Uu, Cud, Uu, Uu, Xu, Xu, Xu, Xu, Xu, Xu, Xu, Xu, Xu, Xu, Xu, Xu
Xu, Xu, Xu, Xu, Uu, Uu, Uu, Uu, Xu, Xu, Xu, Xu, Xu, Xu, Xu, Xu, Xu, Xu, Xu, Xu, Xu, Xu
