Cud, Cud, Cud, Xu, Xu, Xu, Xu, Xu, Xu, Xu, Xu, Xu, Xu, Xu, Xu, Xu, Xu, Xu, Xu, Xu, Xu, Xu
Cud, Cud, 3 Kud, Cud, Cud, Xu, Xu, Xu, Xu, Xu, Xu, Xu, Xu, Xu, Ur, Xu, Xu, Xu, Xu, Xu, Xu, Xu
Cud, Cud, Cud, Cud, Cud, Cud, Xu, Xu, Ur, Ur, Ur, Xu, Ur, Ur, Xu, Ur, Ur, Xu, Xu, Xu, Xu, Xu
Cud, Cud, Cud, Cud, Cud, Ur, Ur, Ur, Xu, Xu, Xu, Ur, Xu, Xu, Ur, Ur, Xu, Ur, Xu, Xu, Xu, Xu
Xu, Cud, Xu, Cud, Ur, Ur, Cud, Cud, Xu, Xu, Xu, Xu, Uu^Vud, Uu^Vud, Ur, Uu^Vud, Xu, Ur, Xu, Xu, Xu, Xu
Xu, Xu, Xu, Xu, Ur, Xu, Cud, Cud, Rr, Hh, Hh, Xu, Xu, Ur, Uu^Vud, Xu, Uu, Ur, Uu, Uu^Vud, Xu, Xu
Uu, Uu, Uu^Vud, Ur, Uu, Xu, Xu, Xu, Hh, Rr, Mm, Mm, Mm, Xu, Xu, Xu, Cud, Cud, Uu, Uu^Vud, Xu, Xu
Uu, Uu, Uu, Ur, Uu, Uu^Vud, Xu, Mm, Mm, Rr, Rr, Mm, Hh^Vhh, Mm, Mm, Xu, Hh, Cud, Xu, Xu, Xu, Xu
Xu, Uu, Uu^Vud, Ur, Xu, Uu^Vud, Xu, Mm, Mm, Hh, Mm, Mm, Rr, Mm, Hh^Vhh, Mm, Hh, Xu, Mm, Xu, Xu, Xu
Xu, Xu, Xu, Cud, Cud, Xu, Mm, Mm, Hh^Vhh, Mm, Mm, Hh, Rr, Hh, Hh, Mm, Hh, Mm, Mm, Mm, Xu, Xu
Mm, Xu, Xu, Cud, Hh, Xu, Mm, Mm, Mm, Mm, Hh, Hh, Rr, Hh, Mm, Mm, Mm, Mm, Mm, Hh^Vhh, Mm, Xu
Mm, Mm, Mm, Xu, Mm, Hh, Hh, Mm, Mm, Mm, Mm, Gs^Fp, Gs^Fp, Hh, Hh, Mm, Hh^Vhh, Mm, Mm, Mm, Hh^Vhh, Mm
Mm, Mm, Mm, Mm, Mm, Mm, Mm, Mm, Mm, Mm, Hh^Vhh, Mm, Gs^Fp, Hh, Hh, Mm, Mm, Mm, Mm, Hh, Mm, Mm
Mm, Mm, Mm, Hh^Vhh, Mm, Mm, Mm, Mm, Mm, Mm, Mm, Mm, Mm, Gs^Fp, Gs^Fp, Gd^Fp, Mm, Mm, Mm, Hh, Hh, Mm
Gs^Fp, Mm, Mm, Mm, Mm, Mm, Hh, Hh^Vhh, Mm, Mm, Mm, Mm, Gs^Fp, Gs^Fp, Rr, Gd^Fp, Mm, Hh^Vhh, Mm, Mm, Mm, Mm
Gs^Fp, Gs^Fp, Mm, Mm, Mm, Mm, Hh, Mm, Mm, Mm, Mm, Hh^Vhh, Mm, Gd^Fp, Rr, Hh, Mm, Mm, Mm, Mm, Hh^Vhh, Mm
Gs^Fp, Gs^Fp, Gs^Fp, Hh^Vhh, Gs^Fp, Hh, Mm, Mm, Hh, Mm, Mm, Mm, Mm, Gs^Fp, Rr, Hh, Mm, Mm, Mm, Mm, Mm, Mm
Gs^Fp, Gg^Fet, Gs^Fp, Gs^Fp, Hh^Vhh, Mm, Mm, Mm, Mm, Hh, Mm, Mm, Mm, Hh, Hh, Rr, Hh, Mm, Mm, Mm, Mm, Mm
Mm, Gs^Fp, Mm, Gs^Fp, Mm, Mm, Mm, Mm, Mm, Mm, Mm, Mm, Mm, Mm, Cte, Cte, Cte, Mm, Mm, Hh^Vhh, Mm, Mm
Mm, Mm, Hh^Vhh, Mm, Mm, Mm, Mm, Hh^Vhh, Mm, Mm, Hh^Vhh, Mm, Mm, Mm, 1 Kte, Cte, 2 Kte, Mm, Mm, Mm, Mm, Mm
Mm, Mm, Mm, Mm, Mm, Mm, Mm, Mm, Mm, Mm, Mm, Mm, Mm, Mm, Hh, Cte, Rr, Mm, Mm, Mm, Mm, Mm
Mm, Mm, Mm, Mm, Mm, Mm, Mm, Mm, Mm, Mm, Mm, Mm, Mm, Mm, Hh, Hh, Rr, Hh, Mm, Mm, Mm, Mm
