Cud, Cud, Cud, Xu, Xu, Xu, Xu, Xu, Xu, Xu, Xu, Xu, Xu, Xu, Xu, Xu, Xu, Xu, Xu, Xu, Xu, Xu
Cud, Cud, 3 Kud, Cud, Cud, Xu, Xu, Xu, Xu, Xu, Xu, Xu, Xu, Xu, Ur, Xu, Xu, Xu, Xu, Xu, Xu, Xu
Cud, Cud, Cud, Cud, Cud, Cud, Xu, Xu, Ur, Xu, Xu, Xu, Ur, Ur, Xu, Ur, Ur, Xu, Xu, Xu, Xu, Xu
Cud, Cud, Cud, Cud, Cud, Ur, Ur, Ur, Xu, Ur, Ur, Ur, Xu, Xu, Ur, Ur, Xu, Ur, Xu, Xu, Xu, Xu
Xu, Cud, Xu, Cud, Ur, Ur, Cud, Cud, Hh, Xu, Xu, Xu, Uu^Vud, Uu^Vud, Ur, Uu^Vud, Xu, Ur, Xu, Xu, Xu, Xu
Xu, Xu, Xu, Xu, Ur, Ur, Cud, Cud, Rr, Hh, Hh, Xu, Xu, Ur, Uu^Vud, Xu, Uu, Ur, Uu, Uu^Vud, Xu, Xu
Uu, Uu, Uu^Vud, Ur, Uu, Uu, Xu, Hh, Hh, Rr, Mm, Mm, Mm, Xu, Xu, Xu, Cud, Cud, Uu, Uu^Vud, Xu, Xu
Uu, Uu, Uu, Ur, Uu, Uu^Vud, Xu, Mm, Mm, Rr, Rr, Mm, Hh^Vhh, Mm, Mm, Xu, Rr, Cud, Xu, Xu, Xu, Xu
Xu, Uu, Uu^Vud, Ur, Uu, Uu^Vud, Xu, Mm, Mm, Hh, Mm, Rr, Rr, Mm, Hh^Vhh, Mm, Rr, Xu, Mm, Xu, Xu, Xu
Xu, Xu, Uu, Cud, Cud, Xu, Mm, Mm, Hh^Vhh, Mm, Mm, Gll^Fp, Rr, Hh, Hh, Mm, Rr, Mm, Mm, Mm, Xu, Xu
Mm, Xu, Xu, Cud, Rr, Xu, Mm, Mm, Mm, Mm, Hh, Gll^Fp, Rr, Hh, Mm, Mm, Mm, Rr, Rr, Hh^Vhh, Mm, Xu
Mm, Mm, Mm, Xu, Mm, Rr, Rr, Mm, Mm, Mm, Gll^Fp, Gs^Fp, Rr, Hh, Hh, Mm, Hh^Vhh, Mm, Mm, Rr, Hh^Vhh, Mm
Mm, Mm, Mm, Mm, Mm, Mm, Mm, Rr, Rr, Gll^Fp, Hh^Vhh, Gll^Fp, Rr, Hh, Hh, Mm, Mm, Mm, Mm, Rr, Gll^Fp, Gll^Fp
Mm, Mm, Mm, Hh^Vhh, Mm, Mm, Mm, Mm, Rr, Gll^Fp, Mm, Mm, Mm, Rr, Rr, Gll^Fp, Mm, Mm, Mm, Rr, Gll^Fp, Gll^Fp
Gll^Fp, Mm, Mm, Mm, Mm, Mm, Hh, Hh^Vhh, Rr, Gll^Fp, Mm, Mm, Gll^Fp, Gll^Fp, Rr, Gll^Fp, Mm, Hh^Vhh, Rr, Rr, Gll^Fp, Gll^Fp
Gll^Fp, Gll^Fp, Mm, Mm, Mm, Mm, Hh, Mm, Rr, Mm, Mm, Hh^Vhh, Mm, Gll^Fp, Rr, Gll^Fp, Rr, Rr, Mm, Mm, Hh^Vhh, Gll^Fp
Gll^Fp, Gll^Fp, Gll^Fp, Hh^Vhh, Gll^Fp, Gll^Fp, Mm, Mm, Rr, Mm, Mm, Mm, Mm, Gll^Fp, Rr, Rr, Mm, Mm, Mm, Mm, Mm, Gll^Fp
Gll^Fp, Gg^Fet, Gll^Fp, Gll^Fp, Hh^Vhh, Mm, Mm, Mm, Mm, Rr, Rr, Mm, Rr, Rr, Hh, Rr, Hh, Mm, Mm, Mm, Mm, Mm
Gll^Fp, Gll^Fp, Mm, Gll^Fp, Mm, Mm, Mm, Mm, Mm, Mm, Mm, Rr, Mm, Mm, Cte, Cte, Cte, Mm, Mm, Hh^Vhh, Mm, Mm
Mm, Mm, Hh^Vhh, Mm, Mm, Mm, Mm, Hh^Vhh, Mm, Mm, Hh^Vhh, Mm, Mm, Mm, 1 Kte, Cte, 2 Kte, Mm, Mm, Mm, Mm, Mm
Mm, Mm, Mm, Mm, Mm, Mm, Mm, Mm, Mm, Mm, Mm, Mm, Mm, Mm, Hh, Cte, Rr, Mm, Mm, Mm, Mm, Mm
Mm, Mm, Mm, Mm, Mm, Mm, Mm, Mm, Mm, Mm, Mm, Mm, Mm, Mm, Hh, Hh, Rr, Hh, Mm, Mm, Mm, Mm
